"number of bedrooms","number of bathrooms","living area","lot area","Area of the house(excluding basement)","Area of the basement","Built Year","Price"
"5","2.5","3650","9050","3370","280","1921","2380000"
"4","2.5","2920","4000","1910","1010","1909","1400000"
"5","2.75","2910","9480","2910","0","1939","1200000"
"4","2.5","3310","42998","3310","0","2001","838000"
"3","2","2710","4500","1880","830","1929","805000"
"3","2.5","2600","4750","1700","900","1951","790000"
"5","3.25","3660","11995","3660","0","2006","785000"
"3","1.75","2240","10578","1550","690","1923","750000"
"3","2.5","2390","6550","1440","950","1955","750000"
"4","2.25","2200","11250","1300","900","1920","698000"
"5","2.5","2820","67518","2820","0","1979","675000"
"4","2","1820","5000","1640","180","1945","650000"
"4","2","1520","6200","1520","0","1945","640000"
"4","2.75","2710","37277","2710","0","2000","630000"
"3","2.25","1750","1572","1470","280","2005","626000"
"4","2.5","2820","8408","2820","0","2014","625000"
"4","3.25","2730","54014","1560","1170","2007","625000"
"3","1.75","2360","7291","1360","1000","1948","615000"
"4","2.5","2730","12261","2730","0","1991","612500"
"3","2.5","3240","33151","3240","0","1995","604000"
"3","1.75","2330","14892","1970","360","1980","588500"
"4","2.5","3310","6500","3310","0","2012","555000"
"4","2.5","1940","10500","1140","800","1976","550000"
"3","1.75","2910","35200","2910","0","1979","550000"
"4","2.5","2860","3345","2190","670","2004","499950"
"4","1.75","1600","6380","1130","470","1959","495000"
"4","1.75","2190","125452","2190","0","1968","491500"
"2","1","880","6380","880","0","1938","490000"
"4","2.5","2710","35868","2710","0","1989","482000"
"5","2.5","2210","9655","1460","750","1976","470000"
"3","1.75","1710","7320","1710","0","1948","463000"
"3","2.5","2680","5539","2680","0","2013","459990"
"3","2.5","2430","88426","1570","860","1985","452500"
"3","2.5","1270","1180","1270","0","2001","445700"
"4","2.25","2160","8119","1080","1080","1966","440000"
"2","1","800","4850","800","0","1944","440000"
"3","2.5","1770","2875","1770","0","1990","439950"
"3","2.25","1970","35100","1970","0","1977","437500"
"3","2.5","1770","1235","1600","170","2007","436110"
"4","1","1450","8800","1450","0","1954","435000"
"4","1.5","1920","10000","1070","850","1954","430000"
"3","2.25","2000","8030","1000","1000","1963","420000"
"3","1.5","1570","6700","1570","0","1956","419000"
"3","2.5","1930","10460","1930","0","1996","407500"
"3","2","1960","13100","1650","310","1957","403000"
"4","2.5","3630","42884","2300","1330","1979","400000"
"3","3.25","1320","1327","1040","280","2008","385000"
"4","1.75","1560","8700","1560","0","1967","382500"
"4","3","3110","7231","3110","0","1997","367500"
"3","1","1090","6435","1090","0","1955","365000"
"3","2","1930","11947","1930","0","1966","342000"
"2","2","1350","2560","1350","0","1976","335000"
"3","2.25","1580","16215","1580","0","1978","335000"
"3","1","1160","9180","1160","0","1968","315000"
"3","1.5","1340","7912","1340","0","1955","313000"
"2","1","850","6174","850","0","1950","308500"
"3","2.5","2540","5050","2540","0","2006","300000"
"2","2.5","1630","1368","1280","350","2009","295000"
"3","3","1850","19966","1090","760","1992","287200"
"4","2.5","2200","9397","2200","0","1987","285000"
"3","2.5","2090","10834","1360","730","1987","285000"
"3","1.75","1800","23103","1800","0","1968","284000"
"3","1.5","1180","10277","1180","0","1983","275000"
"4","2","1480","8625","1480","0","1974","260000"
"3","1.75","1370","5858","1370","0","1987","257950"
"3","1.5","1200","9720","1200","0","1965","242500"
"2","1","1210","9400","1210","0","1949","235000"
"4","2.75","2920","6605","2920","0","2012","625000"
"2","1","900","5000","900","0","1944","553000"
"3","2.5","1650","14054","1130","520","1986","379880"
"3","1","1010","9945","1010","0","1973","310000"
"3","2.5","2850","7130","1990","860","1980","783500"
"2","2.5","2680","7392","2680","0","2004","775000"
"4","2","2280","6010","1140","1140","1900","628000"
"3","2.5","2200","7350","1570","630","1988","365000"
"4","2.5","2530","9933","2010","520","1990","331950"
"7","8","13540","307752","9410","4130","1999","2280000"
"2","2.5","2220","4000","2220","0","2000","1430000"
"5","3.5","4010","8510","2850","1160","1971","1400000"
"4","2.5","4340","141570","4340","0","1992","1090000"
"5","2.75","3190","16920","1690","1500","1976","1030000"
"3","1","1330","77972","1330","0","1928","900000"
"4","4.25","4420","5750","3410","1010","2006","890000"
"5","3.5","4490","6000","3200","1290","2006","890000"
"4","3","3690","9892","3690","0","1998","865000"
"4","2.75","2600","5390","1300","1300","1960","855000"
"4","3","2170","4000","1610","560","1982","831000"
"4","2.5","3400","9692","3400","0","2007","830000"
"6","1.75","2920","5000","2780","140","1908","823000"
"5","2.5","3180","13806","3180","0","1990","800866"
"3","2.5","3240","7857","3240","0","1994","800000"
"3","1.75","1330","7500","1330","0","1961","787000"
"4","2.5","2730","10281","2730","0","1996","780000"
"3","2","2350","5700","1810","540","1939","770000"
"4","2.5","2120","10202","1620","500","1960","755000"
"4","1.75","2010","3600","2010","0","1902","740000"
"4","2.5","3180","21904","3180","0","2000","736500"
"4","2.5","2450","4247","2450","0","2013","712198"
"3","2.5","2490","4343","2490","0","2003","705380"
"3","2.5","1680","2000","1680","0","1909","670000"
"4","2.5","2800","5900","1660","1140","1963","665000"
"4","1","1390","4240","1050","340","1924","657100"
"3","1.5","2160","9000","1400","760","1949","650000"
"4","2.5","2440","6651","2440","0","2014","631625"
"4","2.25","1990","7712","1210","780","1973","627000"
"3","1.75","1480","2185","1480","0","2005","620000"
"3","2","1800","5000","1080","720","1942","618500"
"4","1.75","2300","11700","1960","340","1977","615000"
"3","1.75","1670","39639","1670","0","1976","600000"
"3","1.75","1880","6360","1040","840","1945","600000"
"2","1","1770","8640","1520","250","1949","585000"
"2","1","2540","7000","1320","1220","1942","580000"
"3","2.25","2010","6000","1330","680","1975","570000"
"3","2.5","1900","8744","1900","0","1987","560000"
"3","2.5","1940","3211","1940","0","2009","555000"
"2","1","1140","5400","1140","0","1908","549000"
"4","2.5","2910","6338","2910","0","2008","549000"
"5","2.75","2740","8426","1370","1370","1960","541125"
"2","3","1270","1175","1110","160","2000","531000"
"5","1.75","2550","71874","1810","740","1960","525888"
"3","1.75","1560","5520","780","780","1944","524000"
"3","2.5","1790","2700","1790","0","2010","509900"
"4","1","2070","7519","1160","910","1963","501000"
"4","2.5","2910","6479","2910","0","2006","499000"
"6","2.75","3200","9200","1600","1600","1953","497300"
"4","1.75","2010","9211","1470","540","1977","487585"
"4","3","2340","7048","1340","1000","1979","485000"
"3","2.5","3040","4535","3040","0","2007","478000"
"4","2","1480","3844","1480","0","1928","449250"
"5","2","1840","9240","1540","300","1942","435000"
"2","2.5","1590","1426","1590","0","2014","419190"
"3","2","1410","6030","1410","0","1930","418000"
"3","2.5","1408","989","1408","0","2005","416286"
"3","2.25","1620","998","1540","80","2010","415000"
"3","2.25","1800","36704","1360","440","1978","410000"
"3","2.25","1410","1332","1410","0","2005","406100"
"2","3","1410","1240","1140","270","2006","405000"
"2","1.75","2110","9519","2110","0","1948","400000"
"2","1","840","5510","840","0","1955","400000"
"3","2.5","2230","4000","2230","0","1954","398750"
"5","2.5","3090","12750","1750","1340","1968","384900"
"4","1.75","1970","9389","1140","830","1960","379950"
"3","3","1571","10800","1571","0","2008","366750"
"5","1","1120","9022","1120","0","1962","340000"
"2","1.5","1160","1438","1160","0","2001","340000"
"2","1","1140","5250","1140","0","1949","329950"
"4","2.5","2370","6500","2370","0","1998","328000"
"4","2.75","2310","5000","2310","0","2006","309950"
"3","2.5","1880","7838","1880","0","1994","309950"
"3","2","1050","10072","1050","0","1986","300000"
"3","1","1450","6000","1450","0","1953","287000"
"3","2","1550","15040","1550","0","1958","249950"
"3","1.75","1920","9306","1000","920","1984","245000"
"2","1","1200","8063","1200","0","1958","232000"
"4","1.5","1240","9600","1240","0","1971","220000"
"4","1.5","1120","5427","1120","0","1969","219900"
"3","1","1340","306848","1340","0","1953","210000"
"5","2","2050","10200","1430","620","1956","210000"
"2","1","810","7158","810","0","1944","206000"
"3","1.75","1490","10125","1490","0","1962","184000"
"5","4","4510","15175","4510","0","1969","1870000"
"5","5","4490","10279","3930","560","2013","1800000"
"4","3.25","3760","10920","2400","1360","1950","1580000"
"4","2.25","3490","6906","2280","1210","1928","1230000"
"4","2.75","3370","8103","1970","1400","1970","1140000"
"3","2.5","2200","1970","1610","590","2008","1050000"
"3","2.5","2690","4047","2690","0","2014","979000"
"3","3.5","3020","4082","2080","940","1954","910000"
"4","2","3740","32417","3740","0","2000","860000"
"4","2.5","3040","6425","3040","0","2008","776000"
"4","2.5","3880","14550","3880","0","1987","762300"
"4","2.5","2290","12047","2290","0","1988","736000"
"4","2.5","3200","12369","3200","0","1998","725126"
"4","2.5","3030","7864","3030","0","1999","685000"
"2","1","930","36478","930","0","1951","675000"
"4","3.5","3380","8330","3380","0","2000","655500"
"3","1.5","1630","7475","1160","470","1940","650000"
"5","3.5","3480","36615","2490","990","1983","650000"
"4","2","2060","5000","1030","1030","1949","612500"
"4","3","2450","10117","1580","870","1967","610000"
"4","2.5","2150","37981","2150","0","1985","609000"
"4","2.5","2110","13850","2110","0","1987","606000"
"4","2.25","2260","29930","1400","860","1977","599000"
"4","3.25","3569","8327","3569","0","2013","580000"
"3","1.75","2130","6500","1170","960","1954","575000"
"4","3","3100","15480","2400","700","1996","563000"
"5","2.25","3040","8111","3040","0","1984","562000"
"3","2","2000","5500","2000","0","1916","561000"
"3","2.5","1850","10109","1850","0","1991","535000"
"5","2.75","1800","3780","1400","400","1926","533000"
"5","2.5","2910","5133","1690","1220","1964","530000"
"3","2.5","2970","11985","1770","1200","1995","525000"
"3","2.5","2460","54885","2460","0","1980","520000"
"3","1.5","1430","8000","1430","0","1956","518000"
"3","2.5","1790","7167","1790","0","1989","515000"
"4","2.5","2000","5684","2000","0","1996","513000"
"3","2.5","1480","1171","1480","0","2006","500000"
"2","1.75","1170","2400","740","430","1903","499000"
"5","2","2020","5000","2020","0","1938","488000"
"3","2","1420","4080","1420","0","1905","485000"
"2","1.75","1660","6000","1160","500","1942","484000"
"4","2.5","2740","45732","2740","0","1995","483500"
"6","3","3470","117612","3470","0","1924","475000"
"2","1","1030","4400","1030","0","1924","469000"
"3","2.25","1970","11088","1180","790","1967","465000"
"2","2.25","1230","929","1020","210","2004","460000"
"5","2.5","2240","7770","1340","900","1978","455000"
"2","2","1100","3000","1100","0","1912","450000"
"4","2","1520","7983","1520","0","1967","425000"
"4","2.25","2810","23400","1710","1100","1958","407000"
"4","1.75","1840","10720","960","880","1958","404000"
"4","2","1440","7680","1200","240","1971","397000"
"3","1.75","1260","6500","1260","0","1966","390000"
"5","3.75","2890","5000","1310","1580","2006","390000"
"3","1","1230","9568","1230","0","1962","387000"
"3","1.75","1900","5520","1280","620","1982","385000"
"4","1.75","1500","11600","1000","500","1955","379900"
"3","2","1270","1320","1270","0","2006","369950"
"3","1.5","1410","9647","1410","0","1961","367500"
"3","1.5","1310","8160","1310","0","1950","365000"
"3","2.25","1640","14374","1140","500","1963","362000"
"4","2","2680","18768","2680","0","1965","360000"
"3","1","1350","7740","860","490","1947","353000"
"4","2.5","2331","3826","2331","0","2007","345000"
"3","1","1110","6250","1110","0","1956","345000"
"2","1","720","6687","720","0","1942","329350"
"4","2.5","1890","12040","980","910","1980","325000"
"3","1","1510","6083","860","650","1940","313950"
"4","2","1300","7054","1300","0","1950","312000"
"3","2.25","1980","8000","1560","420","1974","295000"
"4","2.5","2000","5390","2000","0","2003","284000"
"3","1.75","1630","11800","1630","0","1971","280000"
"3","1.75","1580","8151","1100","480","1962","279900"
"3","2.5","1650","13816","1650","0","1998","272000"
"3","1","1050","6874","1050","0","1954","250000"
"3","1.75","1490","8366","1010","480","1975","234000"
"2","1","900","5160","900","0","1952","219000"
"3","1.75","1850","7684","1320","530","1979","218000"
"3","1.75","1690","7735","1060","630","1976","197000"
"3","1.5","800","8850","800","0","1959","191000"
"3","1","1010","7034","1010","0","1954","175000"
"3","1.5","1420","8580","1420","0","1962","136500"
"2","1","780","16344","780","0","1942","78000"
"7","4.5","6210","8856","4760","1450","1910","3200000"
"5","4.5","4270","8076","3400","870","2007","1530000"
"6","2.5","3560","6480","3560","0","1914","1500000"
"3","3","2960","5500","2440","520","1937","1340000"
"4","4","4460","103382","4460","0","2001","1150000"
"4","1.5","2310","13300","1890","420","1950","1110000"
"4","3.5","3900","8391","3900","0","2006","1040000"
"4","2.25","1890","5940","1470","420","1963","940000"
"5","3.75","4130","226076","3170","960","1985","900000"
"4","2","2210","8556","1210","1000","1954","794154"
"3","2","2540","7200","1600","940","1905","775000"
"4","2.75","2410","9549","1780","630","1956","758000"
"3","2.75","2520","23790","1360","1160","1946","750000"
"4","2.75","2600","6050","1960","640","1949","749950"
"4","2.5","2650","4316","1520","1130","1905","705000"
"3","2","1760","6428","980","780","1942","690000"
"3","1.75","1680","10500","1680","0","1959","675000"
"4","4","3680","18804","3680","0","1990","675000"
"3","2.5","3240","108366","3240","0","1991","651000"
"3","3","2270","5175","2130","140","2002","640000"
"3","2.5","2680","327135","2680","0","1995","630000"
"2","2.25","2550","5663","1720","830","2011","630000"
"3","2.5","2030","6500","2030","0","1988","618080"
"3","3","1680","1570","1680","0","2014","610950"
"3","2.5","2460","108900","1860","600","1977","600000"
"9","4.5","3830","6988","2450","1380","1938","599999"
"3","1.75","1960","4788","1090","870","1920","599000"
"4","2","2510","13695","1280","1230","1961","581000"
"4","2","1650","5000","1650","0","1955","575000"
"3","2","2350","5080","1780","570","1929","568000"
"3","3","4120","60392","3180","940","1994","560000"
"3","2","1860","13374","1860","0","1985","560000"
"7","5.75","3700","7647","3700","0","1948","540000"
"3","1.75","2720","149410","2720","0","1988","535000"
"3","2.5","2280","2289","1880","400","2006","535000"
"3","1","1340","4284","1080","260","1910","530000"
"2","2","1550","2400","1550","0","1900","526000"
"3","2.25","1170","1249","1170","0","2014","519950"
"3","1.75","1580","9147","1210","370","1967","515000"
"4","2.5","2430","5203","2430","0","2003","510000"
"3","2.75","1540","6760","1210","330","1980","503000"
"2","1","1010","3885","1010","0","1906","500000"
"3","2.5","1940","37565","1940","0","1987","500000"
"3","1","990","6000","990","0","1943","495000"
"4","2.75","2656","21195","2656","0","2014","495000"
"4","2.5","3305","16164","2245","1060","1922","492000"
"3","2","1610","4160","1010","600","1917","485000"
"4","2.5","2180","11200","2180","0","1968","480500"
"2","1","820","2723","820","0","1921","475000"
"3","2","1760","9055","1760","0","1985","460000"
"3","1.75","1500","6180","1060","440","1947","440000"
"2","2","1350","3900","1350","0","2003","428000"
"2","2.5","1150","1027","1150","0","2008","425000"
"2","1.5","1040","3500","1040","0","1904","420000"
"3","2.25","1770","8165","1770","0","1977","420000"
"3","2.25","1606","1452","1606","0","2009","417250"
"4","3","1830","9548","1830","0","1991","415000"
"4","2.75","2140","13000","1320","820","1968","409500"
"3","2.25","1660","8307","1660","0","1961","405000"
"5","1.75","3000","6000","1500","1500","1958","380000"
"2","1","1640","17335","840","800","1978","379500"
"3","2.5","1830","13042","1830","0","1990","375000"
"5","2.75","2410","5003","1410","1000","2008","365000"
"2","1","820","6400","820","0","1944","361280"
"5","2.5","2420","8560","1620","800","1978","352000"
"3","1","1010","9360","1010","0","1981","350000"
"3","2.25","1630","12295","1630","0","1985","339950"
"2","1","820","681","820","0","2006","339950"
"3","2","1570","7200","1570","0","1952","335000"
"3","1","1040","16986","1040","0","1968","314950"
"3","1.75","1870","12381","1870","0","1957","314500"
"3","1.75","2190","1716","2190","0","1967","313000"
"3","1.75","1840","10723","1220","620","1974","310000"
"3","1.75","2070","37904","1420","650","1973","310000"
"3","2.5","1600","3573","1600","0","2013","305450"
"2","1","760","3001","760","0","1913","300000"
"3","2.5","1600","4271","1600","0","2000","280000"
"3","2.5","1600","7000","1600","0","1993","275000"
"5","1.5","1500","7112","760","740","1920","265000"
"5","2.25","2060","8632","1030","1030","1962","255000"
"3","1.75","1250","10122","1250","0","1994","253000"
"1","1","1100","4373","820","280","1947","250000"
"3","1","1110","8423","1110","0","1952","249000"
"4","1.75","1720","10018","1720","0","1960","248500"
"3","1","1400","7410","1400","0","1944","246000"
"3","1.5","1260","1270","1040","220","2005","245000"
"3","2","1410","7566","1410","0","1985","239900"
"3","2.5","1920","9180","1920","0","1988","230000"
"3","1.75","1640","10762","1130","510","1988","226500"
"3","1.5","1380","11130","1380","0","1960","209950"
"4","1","1490","6600","1490","0","1969","185000"
"2","1","1040","13100","1040","0","1912","160000"
"2","1","910","22000","910","0","1956","100000"
"6","3","3510","5760","3510","0","1906","1750000"
"3","1.75","2430","12757","1340","1090","1952","1500000"
"5","3.25","2800","3200","1910","890","1932","1310000"
"4","3.25","3820","24166","3310","510","1990","1250000"
"4","3","2920","33976","1460","1460","1964","1050000"
"4","1","3410","5000","2190","1220","1910","1040000"
"3","2.75","2015","16807","2015","0","2007","988500"
"5","2.5","3160","11470","1780","1380","1971","980000"
"3","3.25","2640","4080","1840","800","1912","930000"
"3","2.5","2920","3942","2920","0","2008","868500"
"4","2","1910","6960","1910","0","1941","835000"
"5","3","3040","9601","1970","1070","1968","830000"
"3","2.75","3010","1842","3010","0","2011","785000"
"4","1.75","2480","9195","1390","1090","1950","780000"
"4","2.5","2660","5500","2660","0","2003","753888"
"3","2.5","1690","4500","1690","0","1928","719000"
"4","2.5","3290","6465","3290","0","2002","716500"
"3","1","1250","4620","1150","100","1900","712000"
"3","1.75","1320","5750","1320","0","1918","660000"
"4","1.75","2060","26036","1160","900","1947","647500"
"2","1.75","1230","3600","1230","0","1925","636000"
"2","1","1540","6872","820","720","1946","615000"
"3","2.5","1750","3354","1750","0","1991","595000"
"2","3","3160","66646","3160","0","1993","589900"
"4","2.25","2250","41688","2250","0","1980","569000"
"2","2","1870","4950","1870","0","2006","559950"
"2","2.5","1360","1349","1050","310","1997","553650"
"3","2.25","1780","191228","1780","0","1988","545000"
"6","2.25","2820","15600","1970","850","1940","543200"
"4","1.75","1840","9600","1220","620","1967","538000"
"4","2.5","2550","4630","2550","0","2005","537500"
"4","2.5","2280","65836","2280","0","2004","535000"
"3","1","1670","4080","1170","500","1967","533000"
"3","1.75","1980","6760","1980","0","1973","530000"
"4","2.75","2280","2850","1540","740","1930","530000"
"3","2.25","2430","73151","2430","0","1974","524000"
"2","1","1060","4960","1060","0","1926","515000"
"3","1.75","1410","1197","1410","0","2012","500000"
"2","1.5","1110","957","930","180","2005","499000"
"3","2.5","2310","6250","2310","0","2011","494000"
"5","2.25","2440","20828","2440","0","1975","489990"
"3","2","1510","43560","1510","0","1954","450000"
"2","1.5","1020","1060","1020","0","2008","441750"
"2","1","980","1179","980","0","2010","438000"
"3","1.75","1310","9282","1310","0","1976","437000"
"3","1.75","1460","7700","1460","0","1979","424500"
"3","2.5","1540","3200","1470","70","2008","413450"
"2","1","1020","8155","1020","0","1948","405000"
"3","2.75","2090","8354","2090","0","2012","403000"
"3","2.5","1960","8000","1290","670","1977","402000"
"3","1.75","1890","9920","1230","660","1944","385000"
"6","2.25","3206","5793","3206","0","2012","375000"
"2","1.5","960","1808","960","0","1993","358000"
"4","1.75","2250","13515","2150","100","1940","350000"
"3","1.75","1590","9620","1590","0","1988","349000"
"4","2.5","2460","7350","2460","0","1989","347500"
"3","1.5","2240","87625","1480","760","1980","335000"
"2","2","1550","435600","1550","0","1972","330000"
"4","2.5","2320","6270","2320","0","2004","325900"
"2","1.25","860","1277","860","0","2007","321950"
"3","1.75","1890","1716","1890","0","1966","307000"
"3","2","1240","10800","1240","0","1967","297950"
"2","1.75","2200","89298","1100","1100","1973","295000"
"3","2.5","1920","7229","1920","0","1993","295000"
"4","2.5","1810","6509","1810","0","1994","270000"
"3","2.5","1940","8547","1460","480","1989","266000"
"4","2.5","2020","6236","2020","0","2002","262000"
"4","1.5","2130","8800","1100","1030","1962","260000"
"4","1.75","1730","8320","1230","500","1977","258000"
"3","1.75","1390","7399","1390","0","1975","246000"
"3","1.5","1260","7964","1260","0","1955","245000"
"2","1","1270","3008","650","620","1923","235000"
"3","1.75","950","6000","790","160","1939","230000"
"3","1","1390","16000","1390","0","1960","230000"
"3","2.5","1190","3000","1190","0","2002","229000"
"4","1.75","2000","6120","1100","900","1965","228000"
"4","1","2100","9200","1050","1050","1959","211000"
"3","1","1490","8995","1490","0","1954","207000"
"2","1","720","5040","720","0","1955","205000"
"2","1.5","980","5000","980","0","1922","134000"
"2","1","520","22334","520","0","1951","82500"
"3","2.25","3000","11665","3000","0","2001","2400000"
"5","6.5","7270","130017","6420","850","2010","2240000"
"5","4.5","5190","5432","3390","1800","1987","1700000"
"4","2.75","3720","9450","1960","1760","1962","1370000"
"4","4.25","5860","52889","4910","950","1996","1160000"
"4","2.25","4230","37769","4230","0","1989","985000"
"4","3","3750","11025","3750","0","1976","920000"
"3","2.5","3560","107290","3560","0","1987","851000"
"4","3.5","3810","13592","2560","1250","2013","839900"
"4","2.75","3780","10308","3780","0","1999","833000"
"4","3.25","3540","159430","3540","0","2007","800000"
"4","2.5","2830","20345","1980","850","1979","782000"
"4","3.5","2730","3047","2400","330","2006","769900"
"4","2.75","2790","10819","2790","0","1996","765000"
"3","2.25","2950","78843","2950","0","2006","759000"
"4","2.75","3100","3773","2000","1100","1919","742500"
"2","2.5","2200","188200","2200","0","2007","705000"
"3","3","2480","45302","1620","860","1976","610000"
"4","2.5","2260","7753","2260","0","1989","604000"
"4","2.25","2430","32496","2430","0","1993","590000"
"4","3.25","2400","29252","2400","0","1982","585000"
"4","2.5","2660","4000","2660","0","2001","583000"
"4","2.5","2840","6268","2840","0","1998","580000"
"3","2.25","1660","10140","1370","290","1980","566000"
"4","2.25","2470","7447","2470","0","1984","565000"
"4","2.5","2840","4500","2840","0","2012","557000"
"4","2.5","2330","14289","2330","0","1978","542500"
"4","1.75","2000","4000","1450","550","1926","536500"
"3","1.75","1300","5413","1300","0","1925","536000"
"5","3","3480","57499","2340","1140","1976","532000"
"3","2.5","2030","6970","2030","0","1991","525000"
"3","2","1400","7293","1400","0","1963","511555"
"3","2.5","2100","5824","2100","0","1999","505000"
"3","1.75","1750","11340","1300","450","1987","491300"
"2","1","1840","3300","1130","710","1910","490000"
"3","2","1410","4800","1410","0","1940","481450"
"4","2.5","1930","9653","1930","0","1968","465000"
"2","1","1150","4400","1150","0","1905","463000"
"4","1.75","1750","5500","1050","700","1926","460000"
"4","2","1650","6000","1000","650","1959","445000"
"2","2","1150","6634","860","290","1940","445000"
"4","2.25","2170","10500","1270","900","1960","431000"
"3","1","1620","30736","1620","0","1911","428750"
"4","2.25","3060","48787","3060","0","1992","415000"
"4","2.5","2600","11951","2600","0","1988","402500"
"3","2.25","1445","1606","1300","145","2003","387000"
"3","3.25","1410","1253","1410","0","2005","382000"
"3","2","1340","1384","1340","0","2008","376000"
"2","1","1420","81892","1180","240","1956","360000"
"3","2.25","1640","11050","1640","0","1972","352000"
"3","1.75","1780","120661","1780","0","1979","336900"
"4","2.5","1940","3784","1940","0","2003","330000"
"3","2.25","1352","1694","1352","0","2007","325000"
"4","1.5","1470","70800","1470","0","1976","325000"
"3","2.25","998","904","798","200","2007","324000"
"4","2.75","1970","7213","1170","800","1977","323000"
"4","2.25","2310","7490","2310","0","1980","320000"
"5","1.75","2320","8100","1160","1160","1956","315000"
"4","2.25","1930","7452","1430","500","1984","312000"
"4","2.25","2130","8078","1380","750","1977","311100"
"3","1.5","1060","10464","1060","0","1973","303500"
"4","2.5","2000","13300","1200","800","1968","290000"
"3","1.75","1390","8700","840","550","1912","280950"
"4","2","2190","14439","1180","1010","1977","280000"
"3","1.5","1390","48257","1390","0","1922","275000"
"3","1.5","1500","6337","1500","0","1953","270000"
"3","2","1690","9583","1690","0","1969","270000"
"3","2","1920","8075","1510","410","1969","260000"
"3","2.5","1420","14850","1020","400","1963","260000"
"2","1","960","28717","960","0","1984","255000"
"2","1","810","7980","810","0","1928","255000"
"3","2.5","1850","4597","1850","0","2003","254000"
"3","1","1030","6127","880","150","1947","252500"
"3","1.75","1220","7250","1220","0","1962","251000"
"4","3","2163","5883","2163","0","2006","248000"
"3","1","1360","9948","1360","0","1977","234950"
"3","2.5","2000","9202","2000","0","1992","225000"
"4","1","1430","8355","1430","0","1983","224500"
"2","1.5","1020","1525","1020","0","2004","212000"
"3","1","1160","8320","1160","0","1959","201500"
"2","1","720","18000","720","0","1950","195000"
"4","2","2520","6000","1400","1120","1921","875000"
"5","2.75","3060","7015","1600","1460","1979","549900"
"3","2.5","1350","1250","1270","80","2006","394950"
"3","2.5","2130","6969","2130","0","2003","320000"
"4","1","1940","9533","1080","860","1962","265000"
"4","2.5","2160","5298","2160","0","1902","842500"
"3","2.5","1370","1350","1010","360","2007","368000"
"5","2.75","3650","20150","2360","1290","1975","1580000"
"5","1.75","3380","20021","1690","1690","1963","1350000"
"4","3.5","3460","3997","2560","900","2004","1320000"
"4","3.25","2330","9687","2330","0","1918","1300000"
"4","3.75","3490","9170","3490","0","2012","1260000"
"4","4.5","5420","101930","3890","1530","2001","1230000"
"4","2.25","3070","16028","1870","1200","1976","1230000"
"3","1.75","1560","8078","1560","0","1928","1200000"
"3","2.5","3720","11610","3720","0","1982","1080000"
"4","3.75","3280","11000","2320","960","2008","1050000"
"4","3.25","3270","5187","3110","160","2014","1030000"
"3","2.5","2920","34527","1800","1120","1954","1020000"
"5","3","4530","258746","3200","1330","2003","950000"
"4","2.25","3290","12329","3290","0","1968","947500"
"3","2.75","2980","27144","2180","800","1917","947500"
"4","2.75","3300","12090","3300","0","1953","927000"
"3","2","2700","6120","1350","1350","1962","910000"
"4","3.25","4700","38412","3420","1280","1978","900000"
"4","2.5","2830","5000","2830","0","1995","885000"
"3","3.25","2170","12508","1650","520","1928","876650"
"4","2.5","2350","3150","1690","660","1910","870300"
"4","1.75","2350","11914","2350","0","1961","850000"
"4","2.75","2600","2750","1620","980","1936","840000"
"5","4.5","4630","6324","3210","1420","2006","809000"
"4","3.25","3680","5759","2840","840","2003","788000"
"3","1.75","1720","5000","1720","0","1954","770000"
"4","2.5","3110","6142","3110","0","2004","751000"
"4","2.5","2980","4930","2890","90","2000","750000"
"3","2.5","2620","8950","2620","0","1992","746000"
"4","2.5","2760","5000","1680","1080","1928","734200"
"4","2.5","2670","13463","2670","0","1989","690000"
"4","3","2400","3340","1200","1200","1964","675000"
"4","2.5","2550","10000","1290","1260","1964","660000"
"4","2.5","3040","6887","3040","0","1999","647000"
"3","2.5","1570","1433","1570","0","2010","635000"
"4","2","1770","4166","1770","0","1911","630000"
"3","1.5","1620","6630","1280","340","1954","620000"
"2","1.75","2040","4480","2040","0","1919","615000"
"4","3","2110","5000","1640","470","1930","610000"
"4","1.75","2120","4650","1190","930","1951","582000"
"3","2","2560","216777","2560","0","1986","560000"
"4","2.25","2540","228254","1450","1090","1990","540000"
"4","2.25","1800","8623","1360","440","1980","522000"
"4","1.75","1940","4800","1030","910","1922","505000"
"4","2.5","2780","6369","1590","1190","1978","505000"
"2","2.25","1290","1334","1290","0","2007","500000"
"3","1","980","6380","760","220","1941","499950"
"2","2.5","1230","1391","870","360","2004","490000"
"3","1.5","2020","11358","1190","830","1956","465000"
"3","2.5","2010","2287","1390","620","2014","453246"
"3","1.5","1770","17208","1160","610","1959","450000"
"2","2.5","1480","1369","1480","0","2009","420000"
"3","2.25","2200","16921","2200","0","1987","410000"
"4","2.5","2160","6223","2160","0","2010","383000"
"5","3","2480","10090","1300","1180","2004","372500"
"2","2.5","980","895","670","310","2009","369000"
"3","1","1280","9898","1280","0","1968","368000"
"4","2","1730","5500","1010","720","1943","360000"
"4","2.5","2380","7066","2380","0","1997","357000"
"2","1","910","4500","910","0","1906","350000"
"3","1.5","1720","7119","1720","0","1952","341000"
"3","1","1080","8100","1080","0","1955","339000"
"3","2.5","1940","4927","1940","0","2004","335000"
"5","3","2100","4548","1250","850","2013","330000"
"3","1.75","1440","8040","960","480","1951","315275"
"5","2.25","2180","7813","2180","0","1986","302000"
"2","1.5","830","1333","830","0","2005","301500"
"2","1.75","1360","8100","860","500","1975","300000"
"3","1","1830","8209","1830","0","1942","270000"
"2","1","1290","2828","1290","0","2008","265000"
"2","1","1220","2500","770","450","1910","255000"
"1","1","810","2451","810","0","1941","235000"
"3","1","990","8012","990","0","1966","225000"
"3","1.5","1350","7620","1350","0","1941","211000"
"3","2.5","1040","2643","720","320","2004","210000"
"3","1","1460","9750","1460","0","1969","201000"
"2","1","700","10540","700","0","1953","192000"
"3","1.5","1370","8470","1370","0","1961","185000"
"3","1","970","8580","970","0","1959","156000"
"3","1","1250","53143","1250","0","1945","110000"
"4","2.5","5300","26211","4570","730","1923","2560000"
"5","4","4430","9000","4430","0","2013","2450000"
"4","4.5","5030","11023","3250","1780","2008","2450000"
"5","2.25","3120","16672","3120","0","1969","1900000"
"5","3.25","4860","23723","3820","1040","1989","1680000"
"5","3.25","3370","17458","2000","1370","1982","1550000"
"5","4.25","3530","7924","3530","0","2001","1400000"
"4","1.5","2740","4000","1930","810","1905","1110000"
"4","3.25","4400","8400","4400","0","2003","1050000"
"4","2.5","3490","7494","3490","0","2000","975000"
"4","2.5","3520","6773","2650","870","2006","870000"
"4","2.5","3560","11119","2290","1270","1986","860000"
"5","2.75","3150","7119","3150","0","2013","819900"
"6","3","2890","2370","2290","600","1906","799200"
"3","1.75","2340","10495","2340","0","1967","780000"
"3","3.25","3610","59677","2440","1170","2003","777000"
"3","2.25","1780","6120","1390","390","1927","771000"
"3","3.25","3190","5283","3190","0","2007","757000"
"3","1.5","1310","3880","1090","220","1956","717000"
"3","2.5","2030","8398","2030","0","1975","700000"
"4","2.5","3000","5548","3000","0","2006","675000"
"5","3","3410","9600","1870","1540","1968","675000"
"3","2","1940","5820","1150","790","1944","665000"
"4","3.5","3400","5196","3400","0","2012","660000"
"4","2.5","2740","7140","2740","0","1993","651000"
"4","2.5","2210","4861","2210","0","2013","650000"
"3","2.5","1740","13750","1740","0","1975","645000"
"4","1.75","1950","13320","1370","580","1969","635000"
"4","2","2260","6000","1430","830","1958","628000"
"3","3.5","1810","1846","1440","370","2009","625000"
"3","1","1710","4050","1710","0","1909","620000"
"3","1.75","1680","2400","870","810","1922","591000"
"4","2.25","2710","38180","2710","0","1977","591000"
"4","1.75","2090","8164","1070","1020","1963","581000"
"5","2","2290","7125","1190","1100","1964","580000"
"3","1.75","1580","11750","1180","400","1951","575000"
"3","2","1530","5401","1530","0","1937","570000"
"3","1","1440","5000","1440","0","1910","560000"
"4","2","2250","7500","1200","1050","1956","550000"
"7","4","3440","8100","3440","0","1970","550000"
"2","2","1680","4950","1680","0","2006","530000"
"3","1.75","1690","8190","1690","0","1958","530000"
"5","3","2450","4591","2450","0","1994","525000"
"3","3.5","2876","5086","2360","516","2007","525000"
"3","2.5","1580","1161","1010","570","2008","525000"
"3","1.5","1240","7735","1240","0","1957","523000"
"4","2.5","2790","5602","2790","0","2009","505000"
"4","2.5","2040","5616","2040","0","2012","502000"
"5","4.75","3830","35000","2130","1700","1976","480000"
"4","2.5","3740","8700","2260","1480","2004","475000"
"3","1.5","1270","5112","1270","0","1950","465000"
"5","2.5","3400","8970","1700","1700","1959","464000"
"3","2.25","2350","10450","1390","960","1977","460000"
"4","2.5","3360","7685","3360","0","2001","455000"
"3","2.75","1250","892","1040","210","2010","450000"
"3","2.25","2450","42180","2450","0","1978","450000"
"3","2","1770","6610","960","810","1954","449500"
"4","2.25","2140","6355","2140","0","2002","435000"
"3","1.75","1960","5000","980","980","1911","415000"
"4","1","1410","6000","810","600","1925","413000"
"4","1.75","2180","13529","1090","1090","1956","405000"
"3","2","1480","6600","740","740","1943","385000"
"3","1","1190","9486","1190","0","1953","375000"
"5","2.5","3001","5710","3001","0","2006","373000"
"3","1.75","1650","8254","1060","590","1951","370000"
"3","2.5","1490","1709","1490","0","2004","354901"
"3","2.5","2010","14298","2010","0","1977","350000"
"3","1.75","1090","7200","1090","0","1968","345000"
"3","2.5","1450","5008","840","610","2007","330000"
"3","2","1350","14200","1350","0","1989","322500"
"3","1","1390","12823","1390","0","1968","319000"
"3","1","1090","7315","1090","0","1981","289000"
"3","2.5","1950","8251","1950","0","1990","287600"
"3","2.25","1490","9600","1170","320","1987","287000"
"3","1","1090","8640","1090","0","1973","285000"
"4","1.5","2180","22870","1280","900","1954","273000"
"4","2.25","2510","8165","1610","900","1972","267345"
"5","1.75","2020","7902","1220","800","1962","245000"
"3","1","1900","33888","1900","0","1942","239950"
"2","0.75","650","5360","650","0","1931","230000"
"3","1.5","1250","7500","1250","0","1967","225000"
"4","1.5","1950","12559","1950","0","1939","225000"
"3","1","1040","6535","1040","0","1947","225000"
"3","1","1660","7210","1100","560","1963","225000"
"2","1","910","6232","910","0","1943","155000"
"2","1","790","2640","790","0","1973","90000"
"4","2.75","3260","19542","2170","1090","1968","1880000"
"3","2.5","2550","7200","2550","0","1981","1400000"
"4","3.5","4910","9444","3110","1800","2007","1220000"
"4","2.25","4470","60373","4470","0","1988","1120000"
"4","2","2290","11137","2290","0","1955","1060000"
"5","4.5","3810","8019","3810","0","2008","966000"
"5","2.25","2510","9887","2510","0","1972","955000"
"4","2.5","3320","7644","3320","0","1995","950000"
"3","2.5","3100","20553","3100","0","1954","930000"
"4","2.5","2190","7350","2190","0","1958","925000"
"3","2.5","2580","13096","2580","0","1986","802000"
"3","1","1700","4400","1700","0","1906","800000"
"3","2.75","2470","3600","2470","0","2007","773000"
"3","2.5","3030","30007","3030","0","1992","766950"
"5","5","5774","31675","4490","1284","1984","740000"
"4","2.5","3430","10157","3430","0","2000","740000"
"4","2.5","2700","4004","2700","0","2004","723000"
"4","2.25","2060","5649","1360","700","1941","715000"
"4","3.25","3200","7081","3200","0","2004","707000"
"3","1.5","2360","6750","1930","430","1926","702500"
"3","1.75","1830","5120","1830","0","1903","682000"
"4","2.5","2470","33305","2470","0","1993","633100"
"4","2.75","1680","11180","1680","0","1966","625000"
"5","2.5","2540","3832","1760","780","1929","620000"
"5","1.75","2220","6000","1420","800","1923","607500"
"2","1.5","1159","4800","1159","0","1948","582500"
"4","2.5","2240","14667","2240","0","1989","565000"
"3","1.5","1830","8000","1830","0","1957","562000"
"3","1.75","2000","5000","1110","890","1921","546000"
"3","2.5","2090","7640","1360","730","1962","543000"
"2","2","2370","217800","1600","770","1992","543000"
"4","1.75","1900","8250","950","950","1955","542000"
"3","1.75","1400","3825","1100","300","1904","538000"
"4","2.75","2450","15002","2450","0","1974","530000"
"3","1.75","1600","6120","1600","0","1924","525000"
"3","2.5","1820","4883","1820","0","2005","511000"
"3","1.75","2170","54014","1450","720","1986","510000"
"3","2","2090","42689","2090","0","1959","499000"
"4","2.75","2270","7375","1290","980","1973","498000"
"3","2.75","1850","9600","1850","0","1965","489200"
"4","2.5","2150","39449","1420","730","1978","486000"
"4","2.5","2310","14023","2310","0","1991","470000"
"3","1","1660","7500","1060","600","1940","458000"
"3","2.5","2910","17172","2910","0","1989","450000"
"3","2.75","2580","5200","2580","0","2008","437000"
"4","2.5","3040","24123","3040","0","1999","420000"
"2","1","840","3522","840","0","1947","405100"
"2","1","980","2130","860","120","1918","400000"
"2","1","830","4000","830","0","1955","394475"
"4","1.75","1620","4980","860","760","1947","385000"
"3","2.5","1690","1618","1150","540","2014","372977"
"3","1","1290","5500","980","310","1951","372220"
"4","1.75","2010","8625","1340","670","1957","364000"
"3","3.5","2100","12384","2100","0","1980","356000"
"5","3","2257","10117","1363","894","2005","349950"
"3","2.25","2120","15003","2120","0","1984","345000"
"3","2.25","1970","3716","1970","0","1997","340000"
"3","1","1050","5402","1050","0","1906","339950"
"5","2","1700","7314","1000","700","1956","337500"
"3","2.5","2220","6049","2220","0","1990","325000"
"3","2.5","1840","5011","1840","0","2012","317000"
"4","2.5","2010","7226","2010","0","1995","316000"
"3","1","1050","9876","1050","0","1953","310000"
"3","1","1480","7830","1480","0","1952","310000"
"3","1.5","1220","1086","1220","0","2007","306000"
"3","1.75","2110","10200","2110","0","1966","305495"
"4","1.5","1590","131551","1590","0","1966","305000"
"3","1","1260","8280","1260","0","1946","300000"
"2","1.75","1250","34395","1250","0","1950","299000"
"2","1","700","6000","700","0","1949","267800"
"3","2.5","1780","7214","1400","380","1986","266000"
"3","2","1570","5706","1570","0","1998","265000"
"3","2","1850","8250","1150","700","1952","257200"
"4","2.5","2230","4541","2230","0","2006","253000"
"4","2","1630","9010","1050","580","1975","234000"
"3","1.75","1340","7473","1340","0","1973","223000"
"2","1","1240","7200","1240","0","1967","215000"
"2","1","1170","8925","1170","0","1911","175000"
"3","1","860","11900","860","0","1963","160000"
"2","1","700","5200","700","0","1952","155000"
"3","1","1100","17334","1100","0","1978","139000"
"4","1.75","3550","19865","3550","0","1962","2100000"
"4","2.5","3200","7535","3200","0","2006","1260000"
"4","3.5","4210","10308","4210","0","2006","1150000"
"4","3.25","3740","12080","2000","1740","1988","1090000"
"5","4.25","3920","16258","2900","1020","1990","1000000"
"4","2.5","3950","10856","3950","0","2013","914500"
"4","1.75","2930","11562","1670","1260","1947","840000"
"3","1","1230","12305","1230","0","1955","839000"
"4","3.5","3930","5680","2820","1110","2013","828950"
"5","2.75","3030","10335","3030","0","2013","819995"
"4","2.5","3310","5404","3310","0","2004","803100"
"3","1.75","1790","6117","1350","440","1940","790000"
"5","3.75","3580","14275","3190","390","1999","765000"
"4","2.5","3240","20301","3240","0","1985","749400"
"4","3","1980","5352","1980","0","1941","744000"
"3","2.5","3150","151588","3150","0","2007","720000"
"4","3","3150","9130","3150","0","2001","695000"
"3","2.5","4560","17622","3800","760","1986","695000"
"4","3.25","2740","7266","2060","680","2003","689900"
"4","2","2560","7798","1890","670","1947","640000"
"4","2.5","2680","9185","2680","0","1989","620000"
"4","2","1550","4815","1550","0","1909","613000"
"4","2.5","2240","12032","2240","0","1983","592500"
"5","1.75","2000","3750","2000","0","1921","585000"
"4","2.75","2550","7636","1440","1110","1986","582800"
"3","2.5","2360","4638","2360","0","1996","580050"
"2","1","1490","6000","1090","400","1946","575000"
"4","2.5","3020","17810","1600","1420","1979","575000"
"3","2.25","1980","40887","1980","0","1980","550000"
"3","2.5","2700","7434","2700","0","1991","525000"
"3","2.5","1840","2875","1840","0","1997","512500"
"4","2.5","2240","7200","2240","0","1995","497000"
"4","2","2050","4000","1210","840","1941","495000"
"7","3.5","2870","29699","1520","1350","1961","475000"
"3","1","1660","6582","1000","660","1946","467000"
"3","1.5","1260","10350","1260","0","1959","465750"
"3","1.75","1410","6886","1410","0","1924","465000"
"3","2.5","1870","7344","1470","400","1980","455000"
"2","1","1320","4520","1320","0","1912","451555"
"3","2","1510","7066","1230","280","1973","430000"
"4","1.75","1880","7303","1010","870","1976","423000"
"3","2","1640","9972","1640","0","1977","420000"
"3","1.5","1340","10224","1340","0","1956","417000"
"3","1.5","1490","8475","1490","0","1963","412500"
"3","1","1630","10304","1630","0","1953","400000"
"3","1.5","1120","7000","1120","0","1955","395300"
"3","2.5","2240","10800","2240","0","1996","390000"
"3","2.5","1720","3600","1720","0","2010","386380"
"4","1.75","1890","8000","1250","640","1960","375000"
"4","2.5","2710","5880","2710","0","1998","370000"
"3","1.75","1680","250470","1070","610","1940","350000"
"3","1","1400","7066","1400","0","1957","349950"
"3","2.5","1700","7496","1700","0","1994","349950"
"3","2.5","1232","1130","1232","0","2007","344000"
"4","1.75","2290","10290","1340","950","1960","343000"
"3","2.25","1180","9630","1180","0","1986","342400"
"3","1.75","1960","8136","980","980","1948","340000"
"3","2.25","2150","30476","2150","0","1991","335000"
"4","2.5","2150","6807","2150","0","1991","316500"
"2","1","880","6345","880","0","1919","312500"
"3","2.25","1490","974","1220","270","2009","312000"
"4","1.75","2020","7865","1010","1010","1963","302000"
"3","1","1220","13000","1220","0","1955","300000"
"3","1.5","850","2500","850","0","1986","295000"
"3","1","1330","20562","1330","0","1959","280000"
"4","2.5","1840","1562","1400","440","2004","275000"
"3","1","1010","9514","1010","0","1969","270000"
"3","2.25","1590","7748","1590","0","1991","263000"
"3","2.5","1690","5025","1690","0","2003","256883"
"4","2.5","2070","7800","2070","0","1989","255000"
"3","2","1650","7352","1160","490","1979","252350"
"3","1","1230","10350","1230","0","1957","250000"
"3","1.75","1490","6930","1490","0","1990","245000"
"3","2","1400","6200","700","700","1948","240000"
"3","2","1400","7384","1150","250","1979","225000"
"3","1","1040","5000","1040","0","1959","217450"
"3","1","1160","10384","1160","0","1969","215000"
"4","2","1670","9987","1670","0","1967","204700"
"3","1","980","3090","980","0","1903","197500"
"3","1","1090","8520","1090","0","1967","190000"
"3","1","1150","8100","1150","0","1932","185000"
"3","1","1060","5200","1060","0","1970","174950"
"5","4.25","6490","10862","3940","2550","1991","2000000"
"4","3","5520","8313","3570","1950","2008","1270000"
"3","2","2220","6641","1220","1000","1947","875000"
"4","2.75","3280","24440","3280","0","1996","862500"
"5","1.5","3360","5402","3360","0","2014","804995"
"4","3.25","3120","5000","2370","750","2005","799000"
"3","2","2180","5440","1100","1080","1904","785000"
"4","2.5","2110","3750","2110","0","2000","772000"
"4","2.5","3120","14300","3120","0","2003","730100"
"5","2.75","2830","5310","2830","0","2006","725000"
"3","2","2050","3933","1180","870","1926","724800"
"2","1","2020","7200","1700","320","1947","720000"
"5","2.5","3200","6455","3200","0","2009","675000"
"5","3.25","3690","12353","3690","0","1977","655000"
"4","2.5","3160","11380","3160","0","1983","645000"
"3","2.25","1720","4000","1450","270","1921","620000"
"3","2.5","2170","5000","2170","0","2003","619500"
"3","2.5","2720","6439","2720","0","2005","619000"
"3","2.5","2134","1984","2134","0","2008","611000"
"2","1","910","3600","910","0","1909","605000"
"3","2.25","1290","2500","1290","0","1987","605000"
"3","2.25","1520","1221","1520","0","2013","565000"
"2","2","2260","9604","2260","0","1990","551000"
"1","1","1140","6700","1140","0","1920","540000"
"3","1.5","1260","3135","1260","0","1931","523000"
"3","2.5","2370","7875","2370","0","2003","522500"
"2","2.5","1310","1500","1160","150","2006","500000"
"3","2","1450","2400","1450","0","1900","490000"
"2","1","1160","5000","1160","0","1937","490000"
"4","2.5","2430","5000","2430","0","2009","480000"
"3","1.75","1560","4049","1000","560","1926","451000"
"4","2.25","2270","7800","1290","980","1977","446000"
"3","2.25","1990","7340","1990","0","1984","445000"
"3","3","1970","24318","1970","0","2010","445000"
"3","2.5","2320","36847","2320","0","1992","437500"
"4","2.5","2280","7568","2280","0","2001","433000"
"3","1.75","2150","4333","1200","950","1956","430000"
"3","2.5","2670","13218","2670","0","1988","425000"
"3","2.5","1800","5761","1800","0","1990","408200"
"3","2.5","2740","83199","2740","0","1973","400000"
"3","1.75","1180","10541","940","240","1981","385000"
"3","3.25","1860","1787","1860","0","2007","379950"
"3","2.25","1410","1377","1290","120","2005","377500"
"3","1.5","1100","1751","940","160","2007","375000"
"4","2.5","2790","7956","2790","0","2005","375000"
"4","1.5","1370","9957","900","470","1972","370000"
"3","1.75","1726","197326","1726","0","1982","363750"
"1","1","700","5100","700","0","1942","350000"
"4","2.5","2440","4000","2440","0","2009","350000"
"4","1","1980","7991","1980","0","1962","345000"
"3","1","1260","6826","720","540","1944","342000"
"3","2.5","1480","1663","1180","300","2012","341000"
"3","1","1250","4800","1250","0","1951","340000"
"3","1.5","1170","4950","1170","0","1960","330000"
"3","2","1760","11410","1060","700","1977","317000"
"4","2.5","2340","8990","2340","0","2003","314000"
"3","2.25","2060","38377","1560","500","1978","306500"
"3","2.5","1870","5874","1870","0","2005","306000"
"2","1","830","6017","830","0","1954","282613"
"3","2.5","1480","15639","1480","0","1987","275000"
"4","2","1510","4235","1510","0","1955","254000"
"2","1.5","1070","9643","1070","0","1985","252700"
"3","2","1900","6660","950","950","1966","250000"
"3","2.25","1440","7673","940","500","1982","249000"
"4","3.5","1850","6519","1130","720","1986","248000"
"2","1","870","6150","870","0","1941","245000"
"4","1","1530","7200","1400","130","1948","245000"
"5","1","1460","6032","1460","0","1941","239950"
"4","2.25","1860","7000","1120","740","1979","239900"
"3","2","1020","1204","720","300","2004","238000"
"5","1.75","1730","5200","1050","680","1978","205000"
"3","1","1000","18513","1000","0","1940","180000"
"2","1","1010","5200","1010","0","1955","174500"
"3","2","1700","4250","890","810","1944","410000"
"3","2","1940","55756","1940","0","1954","732000"
"4","2.5","2060","7475","1440","620","1985","575550"
"3","2.5","2130","3500","1210","920","1994","534640"
"2","2","1360","4688","780","580","1944","488000"
"3","2.5","2480","8342","2480","0","1986","415000"
"3","2.25","1410","14110","1170","240","1987","352500"
"5","2.5","1970","8605","1970","0","1994","297000"
"5","3.75","5340","10655","3740","1600","1912","2100000"
"4","3.25","5010","34460","5010","0","1988","1470000"
"4","3.5","3410","10769","3410","0","2008","1410000"
"4","2.5","3190","8684","1680","1510","1967","1220000"
"4","3","2240","6000","1270","970","1914","1190000"
"2","1.75","2430","23400","2430","0","1951","1000000"
"3","1.5","2200","5000","2200","0","1932","924000"
"4","2.75","2730","3560","1550","1180","1921","885000"
"5","3.25","4180","49222","2880","1300","1979","869000"
"4","3.5","2640","5900","2640","0","1937","850000"
"2","2.5","2380","9374","2380","0","2011","818000"
"4","2.5","3480","59242","3480","0","1988","810000"
"5","2","3370","5000","2140","1230","1907","762000"
"4","2.5","2660","10452","2660","0","1993","755000"
"4","2.5","3430","64441","3430","0","2013","749950"
"3","1.75","2010","4905","1230","780","1912","700000"
"3","2","1610","5100","1610","0","1940","690000"
"2","2.25","1540","958","1540","0","2007","640000"
"4","2.5","2460","4200","2460","0","1998","611000"
"5","1.75","3290","11900","3290","0","1973","602000"
"2","2","1420","9191","1420","0","1928","592500"
"3","2.25","2030","7350","1190","840","1977","588000"
"4","2.5","2500","4945","2500","0","2013","575000"
"3","2.25","2030","9791","1500","530","1984","572500"
"4","2.25","2110","10698","2110","0","1979","565000"
"4","1","1660","4690","1260","400","1945","560000"
"3","3.5","2320","3174","2060","260","1997","530000"
"4","1.75","2420","2983","1480","940","1979","525000"
"3","1.75","1890","3825","1290","600","1974","524950"
"3","2.5","1680","2096","1380","300","2008","518000"
"4","2","1690","3250","1550","140","1901","487250"
"3","1","1500","4100","1370","130","1926","485000"
"2","2.25","1260","1240","1260","0","2004","485000"
"3","1.75","2200","7706","2200","0","1908","485000"
"3","2.25","1450","1445","980","470","2005","482500"
"4","3.5","3370","435600","3370","0","2005","480000"
"3","2.5","1350","2053","1350","0","2005","477000"
"2","1","1490","3825","860","630","1929","475000"
"4","2.5","3060","10043","1700","1360","1968","475000"
"3","1.75","1630","28600","1630","0","1967","464000"
"3","1.5","1710","990","1410","300","1928","462000"
"5","1.75","1250","10530","1250","0","1966","462000"
"2","1","1060","7193","1060","0","1926","461000"
"5","2.75","2190","12687","1370","820","1978","446000"
"3","1.75","1800","10200","1800","0","1967","442500"
"2","1.5","1010","1968","1010","0","1906","440000"
"3","2.5","2200","3360","2200","0","2009","433500"
"3","2.5","1920","15124","1920","0","1995","429000"
"2","1","770","4000","770","0","1924","413500"
"4","2.75","2500","5257","2500","0","1966","411000"
"4","2.5","2490","8290","2490","0","1999","390000"
"3","2.5","1690","1613","1150","540","2014","386591"
"3","2.5","1670","3565","1670","0","1999","373000"
"2","1.5","1660","4680","830","830","1908","368000"
"2","1","700","2334","700","0","1945","367000"
"4","2.75","2070","9300","1120","950","1945","366500"
"3","1","1290","189486","1290","0","1960","359950"
"3","2.25","1640","7200","1640","0","1985","350000"
"4","2.5","1830","8601","1830","0","2003","339000"
"4","2","1580","7800","1580","0","1906","333000"
"3","2.5","2680","7757","2680","0","1990","320000"
"4","1.75","2310","8045","1650","660","1976","319950"
"3","1","1370","7500","1370","0","1960","307000"
"3","1.75","1610","12247","1610","0","1981","305000"
"5","3","2100","9752","1200","900","2007","298450"
"3","2.75","2170","7900","1380","790","1978","296500"
"4","2.5","1700","7280","1700","0","1988","290000"
"5","1.5","2120","7700","2120","0","1962","290000"
"4","1.75","2080","13629","1040","1040","1955","285000"
"1","1.5","810","3211","810","0","1982","285000"
"3","2.5","1270","9675","1270","0","1993","280000"
"3","2.5","1720","1916","1720","0","2005","280000"
"2","1","1120","9912","1120","0","1980","256500"
"4","1.5","1310","8250","1060","250","1953","251200"
"3","2.25","1580","7941","1580","0","1986","247000"
"2","2","1470","3128","1470","0","2005","241000"
"2","1","910","9612","910","0","1981","225000"
"2","2.25","1610","2040","1610","0","1979","215000"
"3","1","970","7275","970","0","1970","215000"
"3","1","1080","21043","1080","0","1942","210000"
"2","1","930","4743","930","0","1942","141800"
"3","1","950","7620","950","0","1954","137000"
"2","1","680","5000","680","0","1941","110700"
"4","3.5","4460","16953","2550","1910","1962","1800000"
"4","3.75","3300","4545","2600","700","1926","1740000"
"3","1.75","3400","8965","1820","1580","1957","1690000"
"4","3.5","4380","74052","4380","0","2001","1300000"
"4","2","2850","7861","1450","1400","1970","1280000"
"4","3.5","4560","16643","2230","2330","1995","1210000"
"6","3","2880","3192","2180","700","1919","1130000"
"3","2","2390","6888","2390","0","1939","1100000"
"4","2.75","2620","13777","1720","900","1926","978000"
"4","3.5","3120","5086","2480","640","2008","953007"
"4","2.25","2260","41984","2260","0","1967","925000"
"4","2.25","3500","13875","1830","1670","1938","879950"
"4","2.75","3160","8097","3160","0","2014","860000"
"3","1.5","1570","1050","1570","0","1915","792000"
"4","3.5","3070","4684","2190","880","2009","785000"
"3","2.25","1640","1204","1640","0","2014","772000"
"4","2.25","2560","12100","1760","800","1976","765000"
"4","1.75","2450","13300","1630","820","1987","760000"
"6","2","2150","4505","1270","880","1952","755000"
"3","2.5","2770","10773","2770","0","1992","749950"
"4","2.5","3230","7331","3230","0","2004","730000"
"2","1","1790","4000","1040","750","1923","710000"
"4","1","1680","4021","1680","0","1921","700000"
"4","2.5","2650","7945","2650","0","2006","699000"
"4","3","2690","28300","2690","0","1954","675000"
"3","2.25","1990","10260","1990","0","1987","675000"
"4","2.5","2150","12028","2150","0","1982","639000"
"4","2.5","3550","8048","3550","0","2007","625000"
"3","2.5","2480","9041","2480","0","2004","620000"
"3","2.5","1700","4105","1700","0","1992","619500"
"4","2.75","2820","13193","1860","960","1965","615000"
"3","2.5","2660","4975","2660","0","2014","599950"
"5","2.25","2890","12478","2890","0","1977","598000"
"4","1.75","1280","6060","860","420","1926","575000"
"2","1.75","1540","4025","1190","350","1908","570000"
"3","2.5","3050","158558","3050","0","1987","555000"
"3","2.5","2830","5802","2830","0","2001","551000"
"3","1.5","1540","4773","1540","0","1941","525000"
"4","3.5","2680","10000","2040","640","1942","520000"
"4","2","1820","9350","1820","0","1967","519900"
"4","2.5","2670","8765","2670","0","2006","515000"
"3","2","2020","8118","1020","1000","1963","507500"
"3","2.5","1210","1200","1210","0","2008","500000"
"5","3.5","3200","43560","3200","0","1989","499950"
"4","1.75","2090","4300","1250","840","1925","494000"
"3","1","1910","8190","1010","900","1946","490000"
"5","3.5","4460","2975","3280","1180","2015","490000"
"2","1.75","1480","5120","840","640","1951","483945"
"4","2.75","2050","3960","1180","870","1986","480000"
"3","2.5","1260","889","1260","0","2008","479000"
"4","1.75","1650","7775","1150","500","1950","475000"
"3","2.25","1270","1213","1040","230","2005","467000"
"1","2.25","2140","10350","1470","670","1976","458000"
"4","1","1210","3760","1210","0","1900","452000"
"3","1.5","2060","44866","2060","0","1953","450000"
"2","1.75","1300","4000","1300","0","1948","440000"
"3","1.5","1270","1443","1270","0","2007","440000"
"3","2","2010","251341","1510","500","2003","439000"
"3","1.75","1200","4500","1200","0","1906","430000"
"4","2.5","2800","8494","2800","0","2004","426000"
"4","1.75","1940","6909","970","970","1941","423000"
"2","1","1050","60113","1050","0","1943","415000"
"3","2.25","1970","2377","1680","290","2008","415000"
"3","2.5","1800","3168","1800","0","2014","409316"
"5","2.5","2430","4781","2430","0","2001","405000"
"2","1","1730","6375","1730","0","1945","396675"
"3","1.5","1080","2940","1080","0","1920","395000"
"4","2.25","1770","14258","1190","580","1965","390000"
"4","1","1320","4440","1320","0","1929","387500"
"2","2.25","1230","1280","960","270","2012","387000"
"3","1.5","1490","9630","1490","0","1959","385000"
"3","2.5","1700","4000","1700","0","2003","384000"
"4","3","2800","9764","2800","0","2002","380000"
"3","1.75","1690","1468","1380","310","2008","380000"
"2","1","1150","4000","1150","0","1947","376000"
"4","1.75","1590","10523","1590","0","1922","372500"
"4","2.25","2220","6953","2220","0","1999","350000"
"5","3.5","2800","5120","2800","0","1903","345600"
"3","1.5","1240","11200","1240","0","1954","345000"
"3","1","1060","10050","1060","0","1967","335000"
"2","1","860","8308","860","0","1948","330000"
"3","1","1180","43124","1180","0","1959","330000"
"4","2.5","2303","3680","2303","0","2013","329995"
"3","2.5","2170","4905","2170","0","2004","329900"
"4","2.5","1600","6765","830","770","1947","329000"
"6","3","1880","7200","1880","0","1966","326000"
"4","2.25","1870","9680","1170","700","1959","325000"
"3","1.75","1480","7225","1480","0","1965","320000"
"3","2.25","1400","31626","1140","260","1987","315000"
"2","1","790","6969","790","0","1955","315000"
"3","1","1092","7500","1092","0","1918","309000"
"2","2.5","1590","2656","1220","370","2009","305000"
"3","1","1090","9900","1090","0","1955","300000"
"3","1","2120","7735","1060","1060","1967","300000"
"6","5.25","2860","5682","2860","0","1978","300000"
"3","1","910","8000","740","170","1950","299950"
"3","1.75","1560","9788","1560","0","1964","291000"
"3","1.75","1280","10716","1280","0","1969","290000"
"3","2.5","2090","4700","2090","0","2002","289000"
"4","2.5","1860","6687","1220","640","1983","288400"
"2","1","870","5340","870","0","1906","271310"
"2","1","790","8424","790","0","1953","268500"
"3","1.75","1570","7775","1570","0","1982","263000"
"4","2.5","1990","6671","1990","0","1989","260000"
"3","2","1490","7770","1490","0","1990","259900"
"3","1","1320","8625","1320","0","1957","259000"
"4","2","1960","7560","1160","800","1978","250000"
"4","1.5","2500","6300","1500","1000","1961","250000"
"2","1","1770","5522","960","810","1943","243000"
"3","1.5","1650","9936","1090","560","1967","219950"
"4","1.75","2180","28710","1180","1000","1950","210000"
"4","2","1700","6025","1700","0","1978","206000"
"3","1","1050","5000","1050","0","1967","200000"
"1","1","820","1060","760","60","2007","194000"
"2","1","950","7692","950","0","1926","192500"
"3","1.75","1140","9628","1140","0","1969","120750"
"5","4.75","5305","8401","3745","1560","2005","2700000"
"3","3.25","3690","7200","3690","0","2007","1580000"
"3","2.5","4460","26027","4460","0","1992","1550000"
"4","3.25","3660","5800","3360","300","1909","1510000"
"4","2.5","3240","3600","2060","1180","2008","1220000"
"3","2.25","2760","40946","2760","0","1978","1190000"
"4","3.25","3810","8519","2680","1130","2007","1130000"
"2","1.75","1890","8400","1890","0","1987","1070000"
"3","4","3880","13095","3700","180","2009","1030000"
"4","2.75","2290","6120","2170","120","1926","1000000"
"5","4","4850","36450","4850","0","1977","975000"
"4","3.25","2790","5420","1130","1660","1963","970000"
"5","3.75","5330","6000","3570","1760","2006","950000"
"5","3","2876","13927","1970","906","1973","895000"
"4","2.75","3488","9614","3488","0","1998","815000"
"4","2.75","2830","13059","2830","0","1998","744000"
"3","2.5","2020","1159","2020","0","2000","720000"
"4","2.5","3400","247421","3400","0","2001","712000"
"4","2.5","3010","46173","3010","0","1996","700000"
"4","3.25","2780","7875","2780","0","2006","700000"
"4","2.75","2550","8632","1700","850","1972","691000"
"4","2.5","2340","6420","1590","750","1964","668750"
"4","3.5","2350","13402","1670","680","1994","655000"
"4","2.25","2750","6180","1500","1250","1948","635000"
"4","2.5","2630","48706","2630","0","1986","625000"
"4","2.75","2450","14803","2450","0","1988","619420"
"4","2.5","2360","5226","2360","0","2001","600000"
"3","2.25","2230","9053","2230","0","1987","600000"
"4","2.5","2910","5776","2910","0","1998","589000"
"3","2.5","2540","6093","2540","0","1999","567000"
"3","2.25","2020","3600","2020","0","1998","556000"
"3","3","1960","1168","1600","360","2007","556000"
"5","3.25","3010","1074218","2010","1000","1931","542500"
"3","1.75","1300","62290","1300","0","1983","540000"
"3","2","1470","1691","1000","470","2007","540000"
"4","2.5","1900","5790","1900","0","1994","535800"
"2","1","1030","4841","920","110","1939","535000"
"3","2.75","2100","10362","1510","590","1998","525000"
"3","1","1450","4000","950","500","1948","525000"
"4","2.5","3290","11446","3290","0","1992","520000"
"3","2.5","1900","7604","1900","0","1990","512500"
"3","3.5","2380","6250","1670","710","1997","495000"
"4","2","1790","2250","840","950","1909","475000"
"4","2","1660","6150","850","810","1945","452000"
"2","1","1200","4000","1070","130","1940","450000"
"4","2.25","2080","12007","1220","860","1979","442000"
"3","1","1150","3000","1150","0","1906","430000"
"3","2.75","2550","11160","2550","0","1994","430000"
"3","2.5","2420","49928","1860","560","1985","429000"
"1","1","960","40946","960","0","1945","420850"
"3","2","1440","4421","1440","0","2007","413800"
"3","1.75","2470","9620","1570","900","1962","405000"
"3","1.75","1540","12446","1540","0","1967","396450"
"3","2.25","1445","1471","1300","145","2003","389999"
"3","2","1540","7947","1120","420","1961","385500"
"5","2.25","2880","11965","2880","0","1990","382000"
"3","1.75","2000","9416","2000","0","1961","374000"
"3","2.5","2150","7484","2150","0","1988","368250"
"2","0.75","850","7710","550","300","1909","360000"
"3","2.5","1530","1131","1530","0","2009","360000"
"3","1.5","980","7790","980","0","1969","350000"
"4","2.75","1800","5453","1050","750","2002","344500"
"4","2.5","2220","4228","2220","0","2014","334990"
"3","2.25","1800","10500","1800","0","1995","332500"
"3","1","1250","9126","1250","0","1969","330000"
"3","1","990","6750","990","0","1947","325000"
"4","2.25","2000","9000","2000","0","1978","318989"
"2","1","970","13700","970","0","1949","300000"
"3","2.5","2720","6014","2720","0","2002","299900"
"2","1","790","5240","790","0","1925","299800"
"3","2.25","1870","3230","1870","0","1997","288400"
"3","1.75","2380","6000","1320","1060","1935","285000"
"3","2.5","2030","6326","2030","0","1993","275000"
"3","1.75","1390","10905","860","530","1957","270000"
"6","2","2220","8797","2220","0","1977","260000"
"3","2.5","1990","8991","1570","420","1969","256750"
"3","1.5","1060","9039","1060","0","1973","255000"
"3","2","1170","7258","1170","0","1984","250000"
"2","1","1140","5500","1140","0","1947","249900"
"3","1.5","1780","23819","1780","0","1953","246000"
"2","1.75","1330","7200","1330","0","1993","240000"
"5","2","1930","6120","1930","0","1941","230000"
"2","1","1396","111949","1396","0","1940","225000"
"3","1","1060","9126","1060","0","1956","220000"
"4","2.5","2160","8005","2160","0","1993","220000"
"3","1","1020","7874","1020","0","1956","218000"
"3","1","1240","4842","1240","0","1916","210000"
"4","1","1310","5200","1160","150","1945","200000"
"4","2","2030","8120","2030","0","1950","199000"
"3","1.75","1380","7350","990","390","1981","195000"
"2","1","1080","3899","1080","0","1972","195000"
"2","1.75","1100","7600","1100","0","1980","189650"
"3","1.75","1230","13056","1230","0","1962","175000"
"3","1","1010","25000","1010","0","1966","150000"
"4","5.5","5060","10320","5060","0","2008","2150000"
"3","2.5","3160","12824","1820","1340","1966","1600000"
"3","1.75","1610","7200","1090","520","1973","1180000"
"3","2.75","2890","12130","2830","60","1987","1170000"
"6","4.5","6040","219542","4100","1940","1996","1150000"
"4","3","3600","9200","2100","1500","1976","1080000"
"4","3.25","3440","35021","3440","0","1983","1050000"
"4","2.5","3030","12590","3030","0","1988","1050000"
"4","3.75","3860","5474","3860","0","2007","1050000"
"4","3","4260","18687","4260","0","1996","1000000"
"4","2.75","2080","4000","2080","0","1912","940000"
"3","1.5","1660","4800","1660","0","1907","926300"
"4","3.25","3340","10890","2240","1100","1963","910000"
"4","3.25","3090","6744","3090","0","1923","850000"
"4","2.75","2410","6000","1410","1000","1950","805000"
"4","2.5","2350","8001","2350","0","1987","770000"
"4","2.5","2930","18199","2930","0","1998","749000"
"3","2","2000","3207","1100","900","1916","677000"
"4","2.5","2600","17388","2600","0","1996","665000"
"3","2.5","2450","4332","2450","0","2010","660000"
"3","2.5","2670","10496","2670","0","1989","657500"
"4","1.75","2740","8520","1370","1370","1954","657000"
"4","2.5","2860","12394","2860","0","1999","655000"
"4","1.75","2260","7005","1130","1130","1947","648360"
"4","2.5","3240","13978","1860","1380","1977","635700"
"3","1.75","2060","12558","1350","710","1984","625000"
"4","2.5","2980","8107","2980","0","2000","622500"
"4","2.75","2750","14982","1720","1030","1981","604700"
"3","1.75","1650","5100","1040","610","1908","600000"
"4","3","2170","8240","1370","800","1968","592500"
"4","1.75","3000","42200","1500","1500","1950","585000"
"4","2.25","2350","8140","1430","920","1977","555000"
"3","2.25","1670","1596","1220","450","2002","505000"
"2","1.75","2860","59612","1510","1350","1948","503000"
"2","1.75","1560","1750","780","780","1904","494400"
"4","2","1640","5000","1640","0","1907","492000"
"5","2.25","2230","9600","1320","910","1978","482000"
"4","2.25","3250","34293","3250","0","1983","480000"
"3","2.25","1820","8008","1240","580","1981","475000"
"3","2.25","1470","1578","1090","380","2007","432000"
"3","2.75","2200","14925","1100","1100","1982","432000"
"3","3.5","1900","1612","1430","470","2008","431500"
"4","3","3220","8936","2450","770","1990","430000"
"2","2.5","1520","1588","1240","280","2007","430000"
"3","2.25","1950","7221","1950","0","2006","408000"
"3","1","1040","6250","1040","0","1942","400000"
"2","1","590","10945","590","0","1983","398000"
"4","2.5","3140","8060","3140","0","1991","389950"
"3","1","1250","7300","1250","0","1956","385000"
"2","2.5","1230","987","1060","170","2011","380000"
"5","3.5","2420","4670","2420","0","2013","380000"
"2","1","800","3330","800","0","1918","373500"
"4","2.75","3150","67518","2250","900","1965","370000"
"3","1","1100","4046","1100","0","1922","361000"
"3","1.5","1360","885","1360","0","2008","359000"
"2","1.75","1060","16470","1060","0","1977","356000"
"3","2.25","1280","959","1280","0","2005","355000"
"2","1","1060","1600","1060","0","1979","353250"
"1","1","550","1279","550","0","2008","353000"
"4","2.5","2052","3723","2052","0","2014","349900"
"3","1","1220","7876","1220","0","1966","348580"
"3","1","1070","6109","1070","0","1951","337000"
"5","2.25","2000","7900","1300","700","1986","330000"
"4","3.5","3150","6202","3150","0","2005","330000"
"3","2.5","1750","7208","1750","0","1994","324000"
"3","2.25","1347","1292","1347","0","2010","321000"
"3","2","1110","10500","1110","0","1978","320000"
"3","2.25","998","844","798","200","2007","320000"
"2","1","1070","5824","1070","0","1949","319950"
"3","1.5","2320","7500","2320","0","1976","307000"
"4","1.75","2200","169448","1400","800","1942","305000"
"3","3","1860","7440","1040","820","1954","301350"
"6","2","2040","10812","2040","0","1943","300000"
"5","2.5","2760","6000","2760","0","2006","300000"
"4","2","980","10640","980","0","1978","295000"
"1","0.75","1170","14149","880","290","1962","275000"
"4","3","1990","6180","1990","0","1990","273000"
"2","1.5","840","867","840","0","2005","270000"
"3","2.5","1550","3569","1550","0","2011","259000"
"4","2.75","2570","7264","1720","850","1998","254500"
"2","1","940","8532","940","0","1959","249950"
"4","2","1580","8000","1040","540","1967","245000"
"4","2.5","1980","7403","1980","0","1988","243500"
"4","2.25","1720","8300","1720","0","1973","240000"
"2","1","740","11250","740","0","1938","235750"
"3","1","910","6000","910","0","1956","219900"
"3","1","870","5330","870","0","1969","180000"
"2","1","1400","4500","900","500","1922","180000"
"4","1.5","1740","7292","1020","720","1962","180000"
"2","2.5","1160","2174","1160","0","1998","168000"
"2","1","820","10270","820","0","1954","150000"
"4","3.5","4390","11600","3060","1330","1990","1610000"
"4","3","3370","5432","1860","1510","1988","1330000"
"4","3.5","4740","172497","4740","0","2003","1200000"
"3","4","4380","42769","4380","0","1983","1050000"
"4","3","3680","5854","2060","1620","1967","980000"
"5","3.25","3400","7452","3400","0","1999","950000"
"4","2","2840","13367","1420","1420","1952","945000"
"4","2.25","2530","9200","1570","960","1976","902000"
"3","3.5","4080","217697","4080","0","2000","900000"
"4","3.5","4220","196817","4220","0","1993","799950"
"4","2.75","3500","7200","3500","0","2005","788600"
"4","2.5","2380","9614","2380","0","1991","782000"
"3","2.5","2390","9157","2390","0","1984","735000"
"4","2.5","2560","36601","2560","0","1987","675000"
"4","2","1590","6750","1590","0","1951","670500"
"3","2.75","1800","9550","1320","480","1966","665000"
"3","1.75","1240","3600","1240","0","1926","662990"
"4","4","2290","6250","1690","600","1940","661254"
"4","2.75","2250","5700","1200","1050","1951","648475"
"3","1.75","1620","3975","940","680","1926","641000"
"3","2.5","2600","10092","2600","0","1984","625000"
"3","1","1230","8114","1230","0","1951","607000"
"3","1","1500","3920","1000","500","1947","606000"
"3","2.75","1960","5562","1410","550","1926","599000"
"2","1.5","1030","4500","830","200","1924","595000"
"3","2","1670","4572","1670","0","1931","585000"
"3","2.5","1620","1173","1470","150","2008","580000"
"5","2.5","3840","16905","3840","0","1991","556000"
"4","2","3510","12905","2210","1300","1965","554820"
"3","1","1430","5000","1080","350","1919","552000"
"3","2.5","2510","5400","2510","0","1992","550000"
"3","2","1830","9152","1830","0","1959","550000"
"4","3","2830","213879","2830","0","1987","549900"
"3","2.5","2210","7620","2210","0","1994","535000"
"4","1.75","1814","5000","944","870","1951","530000"
"1","0.75","820","59677","820","0","1999","527550"
"3","1.75","1680","3420","960","720","1992","526000"
"2","1","1680","6500","1140","540","1941","515000"
"2","2","1140","8282","1140","0","1924","498000"
"3","1","1280","2580","1280","0","1910","478000"
"3","1.75","1620","8645","1190","430","1973","467100"
"4","2.75","2430","20720","2430","0","1967","465425"
"3","1.75","1120","5500","1120","0","1925","464600"
"3","1.75","1300","2580","820","480","1919","462000"
"3","1","1670","4005","1170","500","1939","460000"
"3","2","1560","4080","1560","0","1923","449950"
"3","2","1630","8702","1630","0","1987","445000"
"4","2.5","2560","10400","1280","1280","1965","440000"
"4","2.5","2380","12067","2380","0","2002","439950"
"4","1.75","1830","9600","1010","820","1966","433000"
"3","1.5","1110","9762","1110","0","1963","416000"
"3","2","1650","9641","1650","0","1983","410000"
"4","3","4060","35621","2030","2030","1989","404000"
"3","2","1540","1827","1540","0","2005","402000"
"3","1.75","2420","12676","2420","0","1911","399500"
"4","2.5","2440","7155","2440","0","1993","388000"
"3","1","1800","5612","1200","600","1942","383000"
"2","1","800","6380","800","0","1940","379000"
"5","1.75","2120","8399","1320","800","1942","377691"
"2","2.5","750","1468","750","0","2006","375000"
"3","2","1270","1323","1270","0","2006","360000"
"3","2","1220","1186","1220","0","2007","355000"
"3","2","1370","78408","1370","0","1964","354800"
"3","1","1010","11244","1010","0","1947","350000"
"4","2.5","1750","8476","1240","510","1983","335000"
"4","2.5","2210","6080","1410","800","1965","334000"
"3","1","1920","6862","1120","800","1952","325000"
"2","1","780","13500","780","0","1946","306000"
"4","2.5","1960","9898","1960","0","2001","300000"
"2","1","1340","7788","1340","0","1947","300000"
"4","1.5","1930","15531","1930","0","1979","275000"
"3","1.75","1620","7540","1310","310","1988","258000"
"3","2","1490","8371","1490","0","1984","255000"
"4","1","1450","8960","1450","0","1943","244000"
"4","2.5","1810","39639","1230","580","1970","235000"
"2","1","1140","1730","1010","130","2007","235000"
"2","1","1300","11867","1300","0","1975","225000"
"3","1","960","9633","960","0","1982","218000"
"4","1","1350","11507","1350","0","1966","200000"
"2","1","1300","44431","1300","0","1958","175000"
"3","1","1700","8645","1700","0","1955","149000"
"3","1","1080","10500","1080","0","1967","132500"
"2","1","580","7500","580","0","1943","90000"
"1","0.75","430","5050","430","0","1912","80000"
"5","4","4580","4443","4580","0","2004","2000000"
"4","4.25","5584","68257","5584","0","1998","1680000"
"4","2.5","3670","7000","3670","0","2005","820000"
"2","1","1010","4320","1010","0","1924","501000"
"3","2.5","1740","5782","1740","0","1989","496700"
"3","1","1370","3000","1370","0","1924","479000"
"3","2.5","2460","4399","2460","0","2007","440500"
"4","1.75","1960","9300","1340","620","1979","372000"
"4","1.5","2670","10026","2670","0","1996","347000"
"3","1.75","1260","6908","1260","0","1994","245000"
"2","1","720","7200","720","0","1943","199000"
"3","3","2980","28000","1820","1160","1981","675000"
"3","2.5","1620","7410","1620","0","1955","355300"
"4","3.5","2630","3435","1640","990","1984","325000"
"3","2.5","1560","4200","1560","0","2003","295000"
"3","1.75","1570","8459","1570","0","1991","195000"
"3","2","2130","35169","2130","0","1989","880000"
"4","2.5","2700","8810","2700","0","2004","690000"
"2","1.5","2730","19877","1570","1160","1976","460000"
"3","1.5","1690","1468","1140","550","1956","379950"
"3","2.5","1780","4050","1780","0","2001","370000"
"4","2.5","2100","3916","2100","0","2009","346000"
"3","1","1140","5000","1140","0","1960","276000"
"3","1","1140","8800","1140","0","1972","172500"
"4","3.25","4060","13000","4060","0","2000","1800000"
"5","4.5","4590","14685","4590","0","2009","1710000"
"4","3.5","3080","4815","2300","780","1937","1660000"
"3","3.25","3790","19000","3790","0","1985","1600000"
"4","3.75","3070","5850","2400","670","1927","1570000"
"4","3.75","3160","9525","3160","0","1997","1380000"
"4","3","5940","11533","4950","990","2004","1150000"
"3","2.75","2640","4050","1750","890","1926","1100000"
"4","2.5","2920","7200","1470","1450","1921","1050000"
"3","2.25","2510","6339","1810","700","1932","994000"
"5","3","3480","15185","3480","0","1964","970000"
"3","3.75","3250","5797","2370","880","1951","967500"
"5","4","3720","15200","3720","0","2005","960000"
"4","2.25","2290","10687","2290","0","1978","949880"
"4","3","3720","29043","3720","0","1991","857000"
"4","2.5","1850","50662","1430","420","1978","830000"
"4","2.5","2680","7200","1380","1300","1952","800000"
"3","3","2520","2152","1560","960","1925","780000"
"4","2.5","3330","7399","3330","0","2009","760000"
"3","2.5","2610","7256","2610","0","2014","754950"
"2","2","1880","5400","1880","0","1902","751750"
"5","2.75","3390","5211","3390","0","2004","735000"
"3","2.5","2330","1987","1410","920","2004","732000"
"3","2","1840","4750","1010","830","1951","730001"
"4","2.5","2740","12899","2740","0","1990","725000"
"3","1.5","2500","4774","1450","1050","1940","725000"
"2","2.5","2160","5581","2160","0","2002","715000"
"4","3","3000","4000","1970","1030","1913","688000"
"3","2.5","2810","7700","2810","0","2001","685000"
"3","2.5","2540","7680","2540","0","1940","675000"
"3","3.5","2710","3475","1650","1060","2005","627000"
"3","2.25","2370","217800","2370","0","1979","587000"
"3","1.75","1850","7735","1850","0","1983","585000"
"3","1.75","1930","36210","1930","0","1977","570000"
"5","4.5","4850","40902","4850","0","2001","569950"
"4","4.25","1960","3565","1960","0","1940","540000"
"2","1","1040","5527","1040","0","1951","535000"
"4","2.5","2340","5600","2340","0","1921","535000"
"3","1","1210","3328","1210","0","1924","529000"
"3","1.75","2310","78844","1760","550","1977","527500"
"5","3","2750","3800","1750","1000","1926","525000"
"4","2.5","3200","6473","3200","0","2005","515000"
"3","2.25","1760","4539","1760","0","1988","500000"
"3","3.5","1820","1501","1430","390","2014","499950"
"4","2.25","1940","9144","1430","510","1956","495000"
"3","2.5","1750","1548","1750","0","2013","495000"
"3","2.5","1590","2550","1590","0","1985","488000"
"3","1","1150","4945","1150","0","1943","480000"
"4","2.75","1720","6270","1720","0","1978","477000"
"3","2","1230","11502","1230","0","1984","475000"
"4","3.5","3400","234352","2500","900","1991","475000"
"2","1","1160","6000","860","300","1942","468000"
"3","2","1560","8640","1560","0","1967","465000"
"3","3.5","1600","1431","1240","360","2006","460000"
"3","1.75","1840","4030","1050","790","1925","457500"
"3","2.5","2420","8252","2420","0","1998","455600"
"3","2","1460","10311","1460","0","1975","455500"
"4","3.25","2510","5311","2510","0","2009","450800"
"4","2.5","2520","8515","2520","0","1999","450000"
"3","2.5","1870","5449","1870","0","2003","445830"
"3","1.75","1650","12940","1650","0","1961","438000"
"3","1","1270","4000","1270","0","1928","435000"
"2","1","920","3780","920","0","1910","427000"
"3","2.25","1950","8868","1350","600","1964","415000"
"5","1.5","1900","10226","1130","770","1961","415000"
"3","1.75","1980","8100","1310","670","1949","405000"
"2","1","910","6490","910","0","1942","405000"
"2","1","1470","6120","1470","0","1940","400000"
"3","3","1296","1051","1296","0","2009","399950"
"4","2.5","2870","9292","2540","330","1979","399000"
"5","2","2330","10750","1190","1140","1962","389000"
"3","1.75","1440","8775","1440","0","1973","375000"
"3","1.5","2000","7294","1520","480","1965","375000"
"2","2.25","1280","835","1080","200","2009","370000"
"3","1","1050","9206","1050","0","1954","360000"
"3","1","1570","9467","1570","0","1954","360000"
"4","2.25","1810","4970","1810","0","2003","355000"
"2","1.5","1180","844","990","190","2005","345000"
"4","2","2330","6250","1400","930","1941","344950"
"4","1","1360","13372","1360","0","1955","330000"
"3","1","1600","5952","1150","450","1964","329000"
"3","1","1810","12375","1810","0","1970","326500"
"2","1","880","7683","880","0","1942","326100"
"3","1.75","1780","13095","1780","0","1983","325000"
"3","1.75","1320","6205","1320","0","1948","313000"
"4","2.5","1630","4473","1630","0","2003","312900"
"3","1.5","1255","1374","1255","0","2004","312000"
"4","1","2100","9288","1050","1050","1968","305000"
"3","1","900","7500","900","0","1972","304000"
"5","1","1410","6400","960","450","1955","295832"
"4","2.5","3250","235063","3250","0","1973","293000"
"5","3","2840","7199","1710","1130","2003","292050"
"4","2.5","1982","6406","1982","0","2004","283200"
"3","2.5","1680","15711","1240","440","1994","282000"
"3","1","1200","6250","920","280","1943","280000"
"3","1.75","1670","7415","1320","350","1987","274950"
"4","2","1930","6600","1030","900","1967","268000"
"3","2.5","1440","7741","1000","440","1983","265000"
"3","2.5","1658","2700","1658","0","2014","263900"
"3","2","1630","8018","1630","0","2003","260000"
"3","1","960","8100","960","0","1955","255000"
"3","1","910","5250","910","0","1971","244000"
"4","2.5","1720","9600","1120","600","1961","200000"
"2","1","1180","9350","1180","0","1918","160000"
"4","3","4260","18000","4260","0","2000","2000000"
"8","3.5","4440","6480","3140","1300","1959","1970000"
"4","3.25","2980","7000","2140","840","1900","1400000"
"4","3.25","4700","9160","2520","2180","2005","1400000"
"4","2.5","3240","10800","2260","980","1946","1290000"
"4","2.75","3650","6982","2530","1120","1951","1210000"
"3","2.5","1970","23180","1100","870","1937","1180000"
"2","1.75","2050","11900","2050","0","1950","1100000"
"7","4","3150","34830","3150","0","1957","999000"
"6","2.75","3610","17580","2070","1540","1959","968000"
"4","2.25","2410","4560","1800","610","1929","960000"
"3","2.5","2690","7000","1840","850","1943","925000"
"6","2.75","2300","24773","2300","0","1950","900000"
"5","1.5","2680","28014","1450","1230","1963","898000"
"3","2.75","2280","4280","1280","1000","1917","875000"
"3","2","2520","5400","1410","1110","1906","840500"
"4","2.75","3040","2800","2100","940","1906","840000"
"4","2.5","3420","8405","3420","0","2000","840000"
"4","1.75","2330","4000","1300","1030","1924","840000"
"3","2.5","2510","5503","2510","0","1995","820000"
"4","2.25","2000","3800","2000","0","2001","815000"
"4","3","2580","209523","2580","0","1984","799000"
"4","3.5","3910","8095","3130","780","2007","782000"
"3","1.75","1490","9800","1140","350","1947","745000"
"2","1.75","2080","4800","1080","1000","1923","740000"
"4","2.25","2920","46355","2920","0","1998","740000"
"3","2.5","2810","5400","2810","0","2005","739000"
"2","1.75","2320","5500","1720","600","1925","700000"
"4","3.5","4490","5099","3390","1100","2006","700000"
"4","2.5","3150","7277","3150","0","2006","681716"
"3","1","1700","6356","1700","0","1907","681000"
"3","2.5","2190","10370","2190","0","1987","665000"
"4","2.5","2990","5669","2990","0","2003","655000"
"3","2.5","2300","5500","2000","300","1921","635000"
"4","2.5","2740","43101","2740","0","1993","630000"
"3","2.25","2180","7741","2180","0","1986","621138"
"4","2","2510","38141","2510","0","1960","600000"
"3","1.75","1580","7416","1150","430","1967","600000"
"4","2.75","2020","2750","1010","1010","1917","599000"
"3","2","1650","6150","1650","0","1926","590000"
"3","1","1110","6000","1110","0","1932","589000"
"5","2","1940","6000","970","970","1945","580000"
"7","4.5","4140","9066","2070","2070","1978","565000"
"3","2.5","3160","4270","2650","510","2006","555000"
"4","1","1660","34848","930","730","1933","550000"
"4","2.5","2230","10414","1450","780","1974","544500"
"3","2.5","1550","12920","1550","0","1999","537000"
"3","2.5","1720","4006","1720","0","1994","535000"
"4","2.5","2680","7178","2680","0","2004","515000"
"3","1.75","1400","4000","870","530","1951","510250"
"4","1.5","2040","8800","1020","1020","1961","510000"
"4","2.5","2798","4473","2798","0","2012","499950"
"4","2.5","2360","4367","2360","0","2003","490000"
"3","2","1980","12150","1980","0","1994","479900"
"2","3.25","1400","1243","1400","0","2000","474800"
"6","3.25","4250","23326","2150","2100","1967","465000"
"3","2.25","1840","5752","1840","0","2003","465000"
"4","3","2230","52983","2230","0","1991","460000"
"3","1","1100","4600","1100","0","1917","450000"
"3","1.75","1610","6480","1610","0","1947","438750"
"3","1.75","1980","5100","1270","710","1965","432500"
"3","3.75","3890","7140","2390","1500","1943","430000"
"2","1.75","1350","6315","1350","0","2005","429000"
"4","2.75","1680","9545","1080","600","1979","425000"
"3","1.75","1820","22320","1250","570","1977","420000"
"3","2.5","2250","3757","2250","0","2006","395000"
"3","2","1660","8281","1660","0","1949","380000"
"3","1","800","2296","800","0","1908","370000"
"4","2.5","3090","18645","3090","0","1995","370000"
"3","1.5","1300","12240","1300","0","1963","365000"
"4","2.5","3753","7204","3336","417","2008","363000"
"2","1","1270","3200","960","310","1920","355000"
"3","2.5","2400","9701","2400","0","1990","355000"
"2","1","1080","4000","1080","0","1940","345000"
"4","2","1480","3132","740","740","1910","335000"
"3","2.75","1720","28000","1720","0","1958","326000"
"2","2.5","1050","1609","1050","0","2005","325000"
"3","2","1300","3731","900","400","1993","315000"
"3","1","1430","19901","1430","0","1927","310000"
"3","2.5","1680","11193","1680","0","1984","306000"
"3","1","1160","11776","1160","0","1968","305000"
"3","1","1390","9624","1390","0","1954","299000"
"2","1","800","6240","800","0","1954","285000"
"4","1","1450","6250","990","460","1964","277000"
"3","1.5","1430","8960","1430","0","1953","270000"
"3","1.75","1300","4127","650","650","1918","270000"
"3","2.5","2495","4400","2495","0","2007","267000"
"3","1.5","1430","9600","1430","0","1966","266200"
"2","1","1060","8187","1060","0","1952","254000"
"3","2","1480","7480","1480","0","1992","254000"
"3","2","1400","8640","1400","0","1968","253400"
"3","1.75","1300","7958","1300","0","1996","245100"
"3","2.5","2060","4030","2060","0","1999","244615"
"3","1.75","1310","9645","1310","0","1979","242000"
"4","2.25","1830","9485","1200","630","1989","236000"
"3","2","2030","24829","1220","810","1979","225000"
"3","2.5","1680","6755","1680","0","1994","225000"
"3","1.5","1560","7300","1040","520","1964","224000"
"3","1","1180","5002","1180","0","1946","220000"
"2","1","1320","8865","1320","0","1943","215000"
"3","1.75","1210","8075","1210","0","1983","215000"
"2","1.5","880","1157","880","0","2007","210000"
"2","2","1700","3171","850","850","1927","189000"
"2","2","1390","1302","1390","0","1986","186950"
"2","1","830","2699","830","0","1996","175000"
"3","1","1100","10125","1100","0","1969","168500"
"2","1","740","9003","740","0","1949","157500"
"2","1","720","4222","720","0","1942","151000"
"3","1","820","7680","820","0","1910","150000"
"2","1","780","6685","780","0","1948","135000"
"3","1","1340","15600","1340","0","1978","124740"
"6","4.25","6980","15682","5330","1650","1999","3100000"
"4","3.25","4430","21000","4430","0","1952","2750000"
"4","3.5","4730","13586","4270","460","1935","2450000"
"4","4.25","4960","6000","3680","1280","1909","1430000"
"5","3.5","5960","13703","4770","1190","1984","1360000"
"4","3.5","4140","13392","4140","0","2000","950000"
"3","2.5","2770","9136","2770","0","1991","860000"
"4","2.25","2280","6660","1960","320","1940","820000"
"5","3.25","2900","12160","1890","1010","1967","790000"
"5","3","2170","2440","1450","720","1911","750500"
"4","2.25","1960","8680","1290","670","1959","723000"
"3","2.5","2390","4555","2390","0","2006","695000"
"4","2.5","2920","9904","2920","0","1990","690000"
"3","1.75","1940","7313","1440","500","1960","685000"
"3","2.25","2330","4000","1520","810","1927","680000"
"4","2.75","2620","6707","2620","0","2000","672500"
"3","2.5","2620","21587","2620","0","1992","672000"
"4","2.75","3310","6166","3310","0","2008","658000"
"3","2.5","2930","6050","2930","0","2008","650880"
"3","3.25","1730","1229","1320","410","2008","645000"
"4","1.75","1640","4240","920","720","1921","635200"
"4","2","2300","3400","1550","750","1915","619000"
"4","2.5","2760","6850","2760","0","1999","602500"
"3","1.75","2930","19876","2030","900","1993","600000"
"3","2","1480","5000","750","730","1928","595000"
"4","2.5","2440","22594","2440","0","1996","565000"
"5","2","2450","9488","1240","1210","1900","550000"
"3","1.5","2600","5085","1400","1200","1940","540000"
"3","2.5","1360","1016","1310","50","2003","535000"
"3","1","1590","6420","1590","0","1944","529000"
"5","2.5","2630","9216","2630","0","2003","525000"
"3","3","2600","5238","1890","710","1989","525000"
"3","1.5","2240","3800","1370","870","1929","510000"
"3","2","2590","54014","1980","610","1988","503000"
"4","1","1600","4300","1600","0","1916","485000"
"3","1","2110","7800","1110","1000","1924","475300"
"6","2.5","4410","14034","2350","2060","1965","472000"
"4","2.25","2590","10002","1340","1250","1968","452000"
"4","2","2240","7725","1120","1120","1956","450000"
"4","2.75","2320","4344","2320","0","2012","449950"
"4","1.75","1990","4725","1190","800","1944","445000"
"2","1","1260","5000","1040","220","1951","436500"
"3","1.75","1950","52256","1950","0","1985","412000"
"3","2","1240","14404","1240","0","1988","405000"
"5","1.75","1880","10000","960","920","1963","405000"
"2","1","710","1173","710","0","1943","402000"
"4","1.5","1390","7200","1140","250","1965","400000"
"4","2.75","1240","3867","800","440","1987","400000"
"5","2","1930","9747","1020","910","1962","400000"
"4","2","1670","12056","1670","0","1955","400000"
"2","1","1320","1824","1320","0","1909","395000"
"2","1","910","7000","910","0","1952","389000"
"2","1","810","4800","810","0","1919","367500"
"4","2.5","2040","22653","2040","0","2011","350000"
"4","1.75","1700","7800","1120","580","1981","349000"
"3","2.25","2270","8876","1380","890","1977","332000"
"3","1.5","1460","5040","1100","360","1971","329932"
"2","2.25","1000","905","1000","0","2006","305000"
"2","1","900","423838","900","0","1925","302000"
"2","1","820","3844","820","0","1916","300000"
"3","2.5","2080","9827","2080","0","1989","300000"
"4","2.5","2290","4539","2290","0","2001","295000"
"3","1.75","1590","4000","1090","500","1957","267500"
"4","1.75","1880","7632","1180","700","1978","266500"
"4","2.25","1720","9753","1120","600","1978","264950"
"3","1.5","1470","14821","1470","0","1958","264000"
"2","1","1500","4120","880","620","1928","262000"
"2","1","1110","26051","1110","0","1951","250000"
"3","1.5","1270","11600","1270","0","1964","246500"
"4","2","1530","6375","1530","0","1942","231000"
"2","1","950","7560","950","0","1958","230000"
"3","1.75","1590","7617","1590","0","1986","210000"
"3","1","1250","6250","1030","220","1949","155000"
"3","1","1010","5490","1010","0","1954","145000"
"2","1","900","8580","900","0","1918","83000"
"4","3.5","5550","28078","3350","2200","2000","3710000"
"4","3.25","4140","20734","3300","840","1977","2400000"
"5","3.5","4180","17935","4180","0","2004","1890000"
"6","2.75","5700","20000","2850","2850","1977","1390000"
"3","2.5","2090","6000","2090","0","1928","1370000"
"4","2.5","3150","13700","3150","0","1966","1260000"
"4","1.75","2500","92347","1500","1000","1970","950000"
"4","3.5","3760","5000","2860","900","2014","919204"
"3","2.25","3060","12095","3060","0","1983","860000"
"7","4.5","4290","37607","4290","0","1982","840000"
"3","2.5","2780","11964","2780","0","2009","825500"
"2","2.25","1730","31491","1730","0","1947","800000"
"3","1.75","1700","8400","1460","240","1947","750000"
"4","2.75","2600","4674","1560","1040","1976","750000"
"5","3.75","3990","18897","3090","900","1937","740000"
"4","3","2840","4120","2060","780","1931","735000"
"4","1.75","3420","7200","1770","1650","1947","715000"
"4","2.5","2310","3570","1490","820","1927","700000"
"4","2.5","2310","5100","2310","0","2013","685000"
"4","2.5","3190","11375","2210","980","1946","659000"
"4","2.25","2060","8470","1440","620","1983","655000"
"2","2.5","1740","2500","1210","530","1994","650000"
"2","1","1890","5202","1890","0","1909","645500"
"3","2.5","2670","10082","2670","0","1987","642000"
"4","2.5","2560","8780","2560","0","1992","642000"
"4","3.25","4240","25639","3550","690","1989","625000"
"4","2","2340","50233","1170","1170","1966","568000"
"3","1.5","2000","7350","2000","0","1953","560000"
"4","2.5","2720","4738","2720","0","2012","545000"
"3","2.5","1950","9906","1950","0","1988","530000"
"4","2.75","2620","6019","2620","0","2013","499431"
"3","1.75","1920","5405","960","960","1947","490000"
"3","2.5","2260","19821","2260","0","1994","489000"
"2","2","1540","54450","1540","0","1983","475000"
"4","2.25","1820","20349","1340","480","1977","465000"
"3","1.75","2580","11000","1290","1290","1951","459900"
"5","2.5","3090","23265","2990","100","1957","458000"
"5","2.75","2220","4000","1230","990","1973","427000"
"3","1.75","1680","3000","840","840","1900","425000"
"3","1.75","1510","44000","1240","270","1989","425000"
"3","2.25","1820","8058","1260","560","1974","425000"
"2","1.75","1340","4664","1340","0","2004","415000"
"2","1","940","4800","940","0","1911","399000"
"4","2.5","2910","5000","2910","0","2002","395000"
"3","2","2120","7560","2120","0","1991","386000"
"3","1","1220","4800","1220","0","1901","385000"
"3","2.5","1860","3690","1860","0","2000","384950"
"3","1","1200","9800","1200","0","1971","374000"
"3","2","1550","8509","1150","400","1959","369000"
"3","2.25","1490","4522","1490","0","2009","365250"
"2","1","1090","5000","730","360","1942","356700"
"3","2.5","2200","7278","2200","0","1990","349900"
"2","1","1000","4776","1000","0","1942","332000"
"2","2.5","1240","1546","1240","0","2007","330000"
"3","1.75","2180","10230","1090","1090","1961","325000"
"4","2.5","2280","7200","2280","0","1994","322000"
"3","2","1060","1716","1060","0","1981","315000"
"3","1","1210","9525","1210","0","1955","299950"
"2","1","1880","7560","940","940","1919","280000"
"3","1.75","1050","5850","1050","0","1980","260000"
"4","1","1290","5000","1290","0","1957","249950"
"3","2","1330","6000","630","700","1900","240000"
"3","2","1560","7352","1560","0","1992","196440"
"3","2.25","1590","11745","1090","500","1978","190000"
"2","1.5","1220","3568","1220","0","1976","168000"
"3","2.5","2460","12028","2460","0","1996","693000"
"3","2.25","2675","40910","2675","0","1984","660000"
"3","2.25","1760","1146","1760","0","2014","615000"
"4","2.5","2550","6256","2550","0","1992","587000"
"5","2.75","2080","13189","2080","0","1987","538888"
"3","2.5","1960","3480","1960","0","2004","289950"
"5","3","3640","8239","2540","1100","1982","1600000"
"4","3.5","3480","7232","2580","900","1926","1510000"
"4","2","2630","16475","2630","0","1953","843500"
"4","1.75","2780","9900","2780","0","1978","660000"
"3","1.75","1620","7330","1090","530","1974","459000"
"1","1","750","4000","750","0","1918","250000"
"3","1.75","1790","12000","1040","750","1960","243000"
"4","3.5","4370","8510","3610","760","2003","1970000"
"5","3.25","3160","13238","3160","0","1972","1250000"
"3","2.5","2230","5750","2230","0","2003","1040000"
"3","2.5","2730","5832","2730","0","1998","1000000"
"3","1.75","1670","5400","1670","0","1912","985000"
"4","2.5","2460","5000","1620","840","1938","965000"
"3","2.25","3020","43560","2720","300","1969","955000"
"4","2.75","3270","12880","3270","0","2014","939000"
"4","3","4500","21780","3040","1460","1980","870000"
"3","1.75","2160","6272","1390","770","1960","820000"
"4","1.5","1840","4337","1840","0","1917","809000"
"2","2.5","2210","6327","2210","0","2003","802000"
"3","3","3740","39640","3740","0","1991","789000"
"4","2","2360","6000","1260","1100","1939","730000"
"4","2.5","3190","7869","3190","0","2001","725995"
"4","3.25","4400","186846","4400","0","1993","687000"
"3","1.5","1840","9990","1840","0","1961","686000"
"3","2.25","2610","9002","2610","0","1988","675000"
"4","2.5","2710","5500","2710","0","1999","668500"
"4","2.5","2720","10000","2720","0","1987","665000"
"4","2.25","1990","4600","1420","570","1932","661000"
"3","2.5","2290","3475","2290","0","2006","653000"
"4","2.5","2430","14400","1670","760","1963","645000"
"3","2.5","1960","4166","980","980","1940","635000"
"3","2","1760","5000","960","800","1920","629000"
"4","2.5","2150","9070","2150","0","1985","615000"
"5","2.5","3990","3839","1990","2000","1962","610000"
"5","2.75","2910","36250","1590","1320","1977","585083"
"4","2.5","2220","7064","2220","0","1988","580000"
"3","2.75","2180","7519","1310","870","1981","568500"
"3","2.75","2930","5569","1860","1070","2004","559900"
"3","2","1810","5040","1810","0","1925","550000"
"3","2.5","1840","3035","920","920","1926","550000"
"3","1.5","1790","8203","1790","0","1910","544000"
"4","1.75","1720","4240","1460","260","1925","540000"
"3","2.5","1690","9626","1690","0","1984","535000"
"4","2.5","2910","7631","2910","0","2006","525000"
"3","2","1720","5525","960","760","1941","500000"
"3","1.75","2770","6250","1580","1190","1978","492000"
"3","2","1750","15500","1490","260","1982","472500"
"3","1","950","4250","950","0","1948","469000"
"3","1.75","1890","7004","1290","600","1965","465500"
"2","1","1170","6000","970","200","1941","455000"
"2","1","1140","5720","850","290","1947","455000"
"2","1","1110","6800","1000","110","1947","440150"
"4","2.75","2340","11034","1720","620","1967","440000"
"2","2","1410","12282","1410","0","1909","439900"
"3","1.5","1120","6900","1120","0","1956","439800"
"3","2.5","2240","6460","2240","0","2002","432500"
"2","1","990","4802","990","0","1947","430000"
"4","2.75","2150","9915","1240","910","1976","411000"
"4","1.75","1790","11875","1490","300","1969","410000"
"2","1.75","1710","4234","1330","380","1920","405000"
"3","1.5","2030","8880","1330","700","1963","404000"
"3","2.5","1495","936","1405","90","2006","400000"
"1","1","730","3000","730","0","1911","395000"
"3","2.25","1410","1290","1290","120","2004","391000"
"2","1","1210","4800","1060","150","1950","380000"
"3","1.75","1510","8301","1510","0","1967","366000"
"3","2.5","2680","7836","2680","0","1990","350000"
"3","1.75","1990","5650","1320","670","1963","345000"
"2","2.5","1175","1366","740","435","2005","342000"
"3","1.5","1320","13200","1320","0","1970","327000"
"5","2.5","3020","21441","1510","1510","1978","320000"
"3","2.25","2130","8721","1570","560","1987","316000"
"3","1","960","6634","960","0","1952","315000"
"2","1.5","1140","2980","1140","0","1988","305000"
"3","1","950","13475","950","0","1950","305000"
"4","2.5","2070","7476","2070","0","2003","300000"
"3","2.5","1950","3600","1950","0","2010","298000"
"3","2.5","2080","4828","2080","0","2002","290000"
"2","2.5","1380","1073","1140","240","2011","285000"
"3","2","1380","4500","1380","0","2008","275000"
"3","1","1450","8820","1050","400","1958","274950"
"4","2.5","1920","8497","1920","0","1998","270000"
"4","2","1850","7560","1540","310","1978","250000"
"3","1","1010","7245","1010","0","1969","199950"
"1","1","720","6000","720","0","1940","155000"
"4","3.5","2790","10125","2790","0","1985","1300000"
"4","3.75","2930","3200","2130","800","1925","1100000"
"4","2","2580","6000","1300","1280","1950","1100000"
"4","3.75","4130","12320","4130","0","2001","1070000"
"4","2.25","2290","5350","2120","170","1958","975000"
"5","2.75","3040","10257","3040","0","1993","960000"
"4","3","4590","9150","3490","1100","1981","960000"
"5","3.5","3490","9680","2460","1030","1980","941500"
"4","2.5","2200","4000","1430","770","1908","930000"
"2","2.5","2680","11214","2680","0","2006","930000"
"4","2.25","3720","12384","1860","1860","1970","875000"
"3","1.75","1370","3850","770","600","1911","850000"
"5","1","2550","4623","2550","0","1905","847000"
"4","2.75","1550","4000","1550","0","1930","835000"
"3","3","2080","10521","2080","0","2004","830000"
"3","2.25","1840","3500","1540","300","1910","785200"
"3","2.5","2430","54059","2430","0","1987","770000"
"4","2.5","2870","12648","2870","0","1986","720000"
"3","1","1030","4958","1030","0","1952","718000"
"3","2","2050","9000","2050","0","1951","713250"
"3","1.5","1660","8797","1660","0","1956","712500"
"3","2","2140","4923","1070","1070","1928","710000"
"4","2.5","2961","12146","2961","0","1998","695000"
"3","2.75","2390","9313","1390","1000","1942","689800"
"3","2.5","2290","2798","2290","0","1953","660000"
"4","2.5","2790","45902","2790","0","1987","654950"
"5","2.75","2550","5040","2550","0","1902","650000"
"3","2.5","2370","11172","2370","0","1993","640000"
"3","2.5","1350","3068","1350","0","1991","613000"
"5","2.5","2070","12000","1340","730","1967","613000"
"5","2.75","2740","5616","1670","1070","1925","605000"
"3","2","2060","4040","1120","940","1947","605000"
"4","2.5","2620","9873","2620","0","1987","600000"
"4","2.5","1960","14242","1290","670","1958","600000"
"4","4.25","2360","57514","2360","0","1939","590000"
"4","2.5","3150","5886","3150","0","2014","580135"
"3","2.25","3800","33825","3330","470","1976","575000"
"4","2.75","3120","7644","3120","0","2010","575000"
"3","1","1300","6710","1300","0","1952","571500"
"3","2.25","2090","12112","2090","0","1983","562100"
"3","1.75","2000","10182","1400","600","1963","560000"
"4","2.5","2170","9600","1460","710","1980","550000"
"3","2.5","2110","11165","2110","0","2001","548000"
"3","1.75","1810","3000","1810","0","1903","545000"
"3","1.75","1250","6041","1250","0","1942","530000"
"3","2.5","2190","4882","2190","0","1999","503000"
"3","1.75","1620","4200","830","790","1945","500000"
"4","2.25","2220","8872","1110","1110","1961","495000"
"5","2.75","2670","3800","2670","0","2014","494995"
"3","2.5","2600","7210","2600","0","1989","475000"
"3","2.25","1800","43647","1800","0","1976","474900"
"4","2.5","3030","9687","2020","1010","1998","471000"
"5","2.75","2040","7488","1200","840","1969","449500"
"2","1","1230","6600","1130","100","1906","440000"
"3","2.25","1680","57063","1680","0","1989","440000"
"5","2","2120","137565","2120","0","1913","437000"
"3","1.75","2220","132858","1110","1110","1988","435000"
"3","2.5","1970","4036","1970","0","2003","432000"
"3","2","1360","5120","910","450","1924","430000"
"4","2.25","1790","7203","1110","680","1973","430000"
"3","3","2340","5002","2340","0","2013","427874"
"3","2.25","1660","6000","1110","550","1979","425000"
"3","2.25","1870","9000","1440","430","1978","425000"
"2","2.5","1140","1182","1140","0","2007","425000"
"3","1.75","1660","9600","1380","280","1981","420000"
"2","1.75","1370","5125","1370","0","1944","409950"
"3","3.25","2780","4002","2780","0","2009","402500"
"3","1.5","1200","4800","1200","0","1962","400000"
"3","2.25","1450","4706","1450","0","2009","400000"
"3","2","1080","7236","1080","0","1947","390000"
"6","1.5","2550","33740","1750","800","1958","375900"
"3","2.5","1720","99916","1720","0","1990","365000"
"4","2.5","2240","3712","2240","0","2014","363990"
"3","2.5","1950","8130","1950","0","1990","328500"
"3","1.75","2250","26337","2250","0","1980","325000"
"3","2","1880","10758","940","940","1952","320000"
"3","3.25","1530","1602","1140","390","2013","320000"
"5","2.5","2090","4698","2090","0","1998","315000"
"4","2.5","1830","5175","1830","0","2003","312000"
"3","2.25","1540","5338","770","770","1954","312000"
"5","2.75","2481","4045","2481","0","2014","309000"
"2","1","1170","10621","1170","0","1963","295000"
"3","1.75","2880","18296","1580","1300","1958","285000"
"2","1.5","1480","15641","1480","0","1940","280000"
"3","1.75","1590","27200","1590","0","1926","280000"
"3","2","1410","7622","1410","0","1983","272500"
"3","1.75","1970","10270","1970","0","1966","268000"
"2","1.75","1220","5000","860","360","1921","253000"
"3","2.25","1765","7652","1765","0","1996","250000"
"3","1.75","1340","16480","1340","0","1968","239000"
"3","1","1040","6860","1040","0","1942","239000"
"3","2","1530","8700","1530","0","1970","235000"
"2","1","720","4840","720","0","1947","235000"
"3","1","1250","15603","1250","0","1959","235000"
"2","1","940","5375","940","0","1952","234000"
"3","2","1440","5000","720","720","1942","230000"
"3","1","1200","9936","1200","0","1969","225000"
"3","1","1030","9120","1030","0","1961","223000"
"3","2","1200","9566","1200","0","1995","222400"
"3","1","1110","7962","1110","0","1962","210000"
"3","1","1060","9600","1060","0","1962","206000"
"3","1.5","1180","9048","1180","0","1960","193000"
"2","2.5","1240","2689","1240","0","1986","174500"
"3","1","1320","8220","1320","0","1959","150000"
"5","3.25","3410","9088","2760","650","1912","2400000"
"6","4.5","3810","28176","3810","0","1969","2010000"
"3","2.5","2660","13367","2660","0","1992","1900000"
"5","2.5","3200","17204","2160","1040","1952","1270000"
"5","3.5","3880","13885","2540","1340","1979","1130000"
"5","2.75","2660","8737","1470","1190","1969","1100000"
"3","1.75","2640","8000","1320","1320","1960","1030000"
"5","3.5","3280","4000","2440","840","2003","989000"
"4","2.5","2770","8642","2770","0","1987","907500"
"4","2.75","3790","10669","3790","0","1999","875000"
"3","1.75","2090","5414","1610","480","1947","865000"
"3","3.25","4720","32467","3190","1530","1998","860000"
"4","2.5","2700","9320","2700","0","1994","837500"
"3","2.25","2430","5500","1810","620","1989","791000"
"3","1.75","1670","9600","1670","0","1961","785000"
"3","2","1630","7599","1630","0","2006","767450"
"4","3","4410","5104","3400","1010","2006","765000"
"3","2","1990","3990","1130","860","1912","760500"
"4","2.5","2730","36183","2730","0","1986","760000"
"4","2.75","3370","12447","3370","0","1991","760000"
"4","1","1540","115434","1540","0","1923","759600"
"3","2.25","2370","9619","1650","720","1973","746000"
"3","3.25","1540","704","1540","0","2011","742000"
"4","2.5","2770","45514","2770","0","1989","685000"
"3","2.25","2560","41346","2560","0","1986","658588"
"4","2.5","3290","6203","3290","0","2008","648000"
"4","2.25","2500","8500","1600","900","1978","646000"
"3","2.5","1690","1553","1690","0","2007","640000"
"4","3.5","2910","5260","2910","0","2012","610000"
"4","2.5","4060","9734","2150","1910","1977","603500"
"3","2.5","1780","1487","1600","180","2006","586500"
"6","2.75","2630","16411","1650","980","1974","583000"
"3","2.25","1830","7897","1290","540","1986","572000"
"5","2.5","2650","11455","1400","1250","1961","565000"
"3","2.5","2070","12708","2070","0","1996","560000"
"4","2.25","2740","88426","2740","0","1991","549000"
"5","2.5","2730","17240","1660","1070","1958","545000"
"3","1","1050","4160","1050","0","1925","540000"
"3","2.5","1710","2300","1570","140","2005","539000"
"3","2.5","1820","4910","1820","0","1993","532000"
"4","1.75","2020","7029","1430","590","1979","532000"
"3","2","1540","7800","1540","0","2004","525000"
"3","3.25","1540","1487","1540","0","2011","520000"
"2","1","830","2820","830","0","1920","519000"
"5","3","2920","11440","2920","0","2003","500000"
"3","2.5","1520","2208","1040","480","2007","499950"
"3","1.5","1020","9072","920","100","1930","489000"
"3","2.5","2340","59058","2340","0","1985","485000"
"3","2","1800","12669","1800","0","1956","470000"
"3","1","910","4500","910","0","1948","465000"
"3","1.75","1420","1189","1420","0","2006","455000"
"5","2.5","2300","23345","1170","1130","1967","453500"
"2","1.75","1500","6800","910","590","1942","437000"
"4","2.5","2460","5091","2460","0","2003","427500"
"3","2.5","2060","4399","2060","0","2007","418500"
"4","2.5","2000","5962","2000","0","1999","415000"
"3","1.75","1840","5101","1040","800","1952","411715"
"3","1.75","1530","10731","1530","0","1986","400000"
"3","2","2260","11305","1130","1130","1986","400000"
"3","1.5","2080","5244","1190","890","1959","399950"
"4","2.5","2150","7303","2150","0","2005","392500"
"3","2.25","1250","7500","1250","0","1942","390000"
"3","1","1240","11108","1240","0","1952","390000"
"4","1.75","2200","7475","1100","1100","1955","375000"
"2","1","820","6250","820","0","1922","375000"
"3","1.5","1420","4500","1420","0","1959","371000"
"2","1","1250","8100","1250","0","1947","365000"
"4","2.5","2310","8030","2310","0","1978","364950"
"2","1.75","1650","4000","950","700","1947","355000"
"3","1.75","2190","12626","2190","0","1978","340000"
"4","2.75","2540","7210","1600","940","1979","335000"
"3","1","1070","7140","1070","0","1989","327500"
"4","1.75","1650","7800","1650","0","1968","327500"
"3","1","1210","7440","1210","0","1949","324950"
"3","1.5","1650","9380","1130","520","1978","320000"
"3","1","1010","5400","1010","0","1959","317000"
"3","2","1350","11150","1110","240","1995","310000"
"1","0.75","560","12120","560","0","1967","299000"
"3","1.75","1730","11325","1730","0","1972","292000"
"3","2","1670","7757","1670","0","1992","289950"
"3","2.5","2437","5136","2437","0","2011","285000"
"2","1","960","9253","960","0","1942","280000"
"3","2.5","1720","8755","1000","720","1983","275000"
"2","1","770","8149","770","0","1948","275000"
"3","2.25","2080","4252","1550","530","2003","270000"
"3","1.5","1810","29308","950","860","1983","261000"
"3","2","1710","7225","1710","0","1988","250500"
"4","2","2120","8701","2120","0","1960","250000"
"3","1.75","1460","10584","990","470","1997","240500"
"3","1.75","1770","33224","1770","0","1968","229500"
"3","2.25","1500","7615","1150","350","1984","219950"
"3","1","920","14400","920","0","1977","212500"
"3","1.5","2060","15837","2060","0","1903","200000"
"5","2","1750","10284","1750","0","1943","190000"
"2","1","670","2378","670","0","1919","175000"
"2","1","1500","18540","1500","0","1950","170000"
"4","1.75","1720","7200","1220","500","1974","161700"
"1","1","790","13062","790","0","1942","135000"
"1","1","650","15364","650","0","1967","129000"
"3","1","1170","11000","1170","0","1980","119500"
"5","4.5","4400","15580","3390","1010","2003","1800000"
"4","5.25","4670","43950","4670","0","1989","1420000"
"6","4.5","3902","3880","2782","1120","1977","1300000"
"4","2.25","2980","8051","2020","960","1935","1160000"
"5","4.75","5180","17811","4070","1110","2001","1080000"
"4","4.25","5660","193593","4100","1560","2001","955000"
"4","2","2660","3900","1480","1180","1923","886000"
"3","3.5","3250","6000","2500","750","2001","875000"
"5","2.5","2920","5568","2320","600","1906","875000"
"4","3.5","3500","8547","2500","1000","1994","799000"
"3","3.5","3590","6402","3590","0","1999","798000"
"4","2.25","2070","13084","1700","370","1967","795000"
"4","2.75","3110","35235","3110","0","1983","749950"
"3","2.5","2670","10338","2670","0","1987","749000"
"4","2.75","2420","10962","1530","890","1977","725000"
"3","1.75","1910","4800","1080","830","1959","700000"
"3","2.5","2050","4185","2050","0","2011","700000"
"3","2.75","3150","219978","3000","150","1990","685000"
"3","2.5","2680","9750","1610","1070","1979","653000"
"3","1.75","1290","3870","1290","0","1916","647500"
"3","1.75","2340","4206","1170","1170","1917","640000"
"4","3.75","4610","40202","2500","2110","1980","630000"
"4","2.25","2400","5350","1460","940","1929","620000"
"4","1.75","1660","3800","1660","0","1926","619000"
"4","1.75","1830","29110","1230","600","1990","610000"
"4","2","1370","4000","1370","0","1951","605004"
"3","2.5","1480","1485","1280","200","2007","584000"
"3","2.75","2390","9966","1360","1030","1977","565000"
"3","1.75","1980","6250","1090","890","1910","564000"
"4","2.5","2260","3713","2260","0","2003","560000"
"4","2.75","2020","10720","1420","600","1976","555000"
"4","2.5","2700","5150","2700","0","2007","550000"
"3","2.5","1480","8381","1480","0","1968","547000"
"2","1","970","3400","970","0","1924","546000"
"3","1.75","1700","51649","1700","0","1931","545000"
"4","2.25","1330","8400","1330","0","1962","540000"
"4","2.25","2210","7665","2210","0","1968","530000"
"4","3.25","4160","35654","2760","1400","1973","530000"
"3","2.5","1710","1664","1300","410","2003","529999"
"3","2.5","2370","12753","2370","0","2001","499950"
"3","2.5","2520","53143","2520","0","1988","499500"
"3","3.5","1690","1432","1360","330","2008","499000"
"5","3","2440","4750","1450","990","2006","495000"
"4","3.75","2810","10840","2070","740","1994","492000"
"3","2.5","1480","14250","1480","0","1996","466800"
"3","1","1430","3840","950","480","1945","466500"
"3","2.25","1530","1245","1050","480","2014","465000"
"3","2.5","1640","29970","1640","0","1992","463000"
"4","1.75","1670","9886","1670","0","1947","456000"
"4","1.75","2000","6032","1300","700","1959","453500"
"4","1","2000","4676","1250","750","1916","450000"
"3","2.5","2170","4912","2170","0","2003","449950"
"4","2.5","2340","3827","2340","0","2008","445000"
"3","1","1050","7500","1050","0","1900","440000"
"4","2.75","2440","15349","2440","0","1957","425000"
"4","2.5","2658","3960","2658","0","2014","411605"
"3","1.75","1460","22651","1460","0","1961","395000"
"4","3","1980","7931","1160","820","1983","395000"
"3","2","1463","868","1463","0","2003","390000"
"3","2","1330","8100","1330","0","1969","386000"
"3","2.25","1710","11500","1210","500","1978","385000"
"4","2.75","2420","5773","2420","0","2005","376000"
"3","1.75","960","8106","960","0","1962","375000"
"3","1.5","1180","12324","800","380","1981","372500"
"4","2.5","2390","6426","2390","0","1999","359800"
"2","1","920","4095","920","0","1914","356000"
"3","2.5","2600","5540","2600","0","2004","355500"
"4","2.5","2070","4500","2070","0","2004","343000"
"4","2.5","2610","4781","2610","0","2009","335000"
"3","2","1170","5360","1170","0","1919","335000"
"3","2.5","1660","3990","1660","0","2009","324500"
"4","2.25","2192","12128","2192","0","2006","310000"
"4","1.75","1560","31299","1560","0","1965","299950"
"4","2.5","1910","5000","1910","0","2005","297500"
"5","2.5","2490","7666","1490","1000","1989","292000"
"3","2","1680","8424","1680","0","1993","289000"
"3","2","1750","9750","1350","400","1961","279950"
"4","2.5","2068","7242","2068","0","1976","276000"
"3","3","1390","1080","1140","250","2006","275000"
"3","1.5","1890","9450","1090","800","1957","270000"
"3","1","1500","13500","1500","0","1968","270000"
"3","1","1690","4250","1020","670","1967","269000"
"4","2.5","2100","4237","2100","0","2006","268500"
"4","2.75","2330","7642","1800","530","1990","257000"
"3","2.5","1610","5000","1610","0","1994","255000"
"3","2.5","1510","10384","1030","480","1976","250000"
"3","1","1150","4825","1150","0","1957","240000"
"3","1","1130","10650","1130","0","1954","237000"
"2","1","1190","7408","830","360","1941","229000"
"2","2.5","1150","2064","1150","0","2004","214100"
"4","1.5","1920","10403","1370","550","1959","210000"
"3","1","1010","7560","1010","0","1958","189000"
"3","1","1150","19200","1150","0","1908","165000"
"4","3.5","4280","9583","4280","0","2005","1600000"
"2","2.25","2460","16940","1930","530","1936","1370000"
"4","4","4270","6002","3180","1090","2004","1300000"
"4","3.5","3010","3600","2370","640","1999","1280000"
"3","1.5","2170","16600","1130","1040","1979","1150000"
"5","2.75","4400","18500","2250","2150","1963","1120000"
"4","3.25","3450","11240","2430","1020","1960","1040000"
"4","2.5","4150","8436","4150","0","2014","969990"
"4","2.75","2880","5750","1710","1170","1928","920000"
"4","3","3240","5562","3240","0","2013","895000"
"4","2.75","3010","7215","3010","0","2014","879950"
"5","2.75","3030","7679","3030","0","2014","837219"
"2","2","2280","6815","2280","0","2002","835000"
"4","2","2230","9900","2230","0","1959","809950"
"5","2.5","4600","19831","2300","2300","1956","805000"
"3","2.5","2670","12187","2670","0","1986","744000"
"4","3","2720","3800","1800","920","1919","739000"
"4","2.5","2820","6180","2050","770","2013","735000"
"3","2.5","2550","13458","2550","0","1990","715000"
"3","2.25","2270","23900","1820","450","1975","680000"
"3","1.75","1980","3300","1140","840","1926","660000"
"4","2.5","2840","9354","2840","0","1990","650000"
"4","2.5","2560","5593","2560","0","2001","600000"
"4","2.5","1990","2175","1680","310","2005","595000"
"4","2.5","2630","6326","2630","0","2008","589500"
"4","2.5","2430","4747","2430","0","2008","585000"
"3","2.5","2400","6975","2400","0","1993","570000"
"3","1.5","1900","5000","1640","260","1926","550000"
"4","2.5","2040","6034","2040","0","1990","545000"
"3","2.5","3080","12476","3080","0","1990","539500"
"3","2","2260","9568","1780","480","1985","539000"
"3","1.5","1730","40250","1730","0","1983","535500"
"5","2.75","2440","8000","1240","1200","1972","525000"
"3","1.75","1480","7040","1480","0","1974","510000"
"4","1.5","1320","14250","1320","0","1954","510000"
"4","1","1720","4011","1720","0","1904","500000"
"2","1","890","4590","890","0","1923","475000"
"3","2.5","2030","2805","1720","310","2001","471000"
"4","2.25","2070","7500","2070","0","1977","465000"
"4","2.25","1740","8449","1170","570","1958","455000"
"4","1.75","2050","94525","1250","800","1959","455000"
"2","1.75","1740","5400","990","750","1946","452000"
"3","2.5","1480","1961","1480","0","2005","450000"
"4","2","1470","8395","1470","0","1965","445000"
"4","2.75","3270","50994","2720","550","1983","435000"
"2","1","1260","4080","1260","0","1926","435000"
"3","2","980","5000","980","0","1940","435000"
"3","1.75","1470","6250","1070","400","1939","432000"
"3","1.75","1910","12596","1340","570","1977","415000"
"4","2","1880","14653","1880","0","1978","407193"
"2","2","1405","1073","1140","265","2007","405000"
"3","2.5","2700","9994","1350","1350","1959","402000"
"2","1.5","1490","4080","930","560","1956","389250"
"3","1","1560","14333","1560","0","1953","387500"
"4","1","1550","7740","1550","0","1954","385200"
"3","1.75","1020","7020","1020","0","1953","360000"
"3","1.75","1370","9900","1370","0","1983","320000"
"3","1.5","1750","12500","1150","600","1954","315000"
"4","2.5","2680","15508","2680","0","1999","300000"
"3","2","1970","9600","1300","670","1967","294700"
"2","1","780","5000","780","0","1943","285000"
"5","2.5","2690","5557","2690","0","2012","279000"
"4","2.25","1900","8600","1900","0","1975","270000"
"2","1","810","4800","810","0","1948","253500"
"2","1","1730","9610","1380","350","1962","200000"
"3","1","1840","5000","920","920","1953","185000"
"3","1","1210","103237","1210","0","1918","160000"
"6","2.5","3820","53173","2040","1780","1974","611000"
"4","2.5","2460","5500","2460","0","1998","568500"
"3","3","1730","2940","1730","0","1985","490000"
"4","2.5","3070","6432","3070","0","2006","462000"
"4","3.25","4420","7850","3150","1270","2001","2700000"
"4","2.25","2370","9360","2370","0","1979","684680"
"3","2.5","2300","7398","2300","0","2001","567500"
"4","2.5","1780","4169","1780","0","1994","540000"
"5","3","2870","4369","2090","780","2007","540000"
"3","2.75","3400","7200","2470","930","2009","530000"
"4","2.25","2450","62290","2450","0","1976","510000"
"3","1","1300","3550","1300","0","1927","455000"
"2","1","1440","3225","960","480","1915","445000"
"4","2.5","1811","4381","1811","0","2007","260000"
"4","3.25","4130","112521","4130","0","1978","1900000"
"5","3.5","4220","26784","2110","2110","1958","1640000"
"4","3.25","3300","15907","3300","0","1985","1350000"
"4","2.5","4250","19387","3260","990","1972","1340000"
"4","2.5","2740","16007","2740","0","1984","1230000"
"3","2.5","2850","10474","1730","1120","1954","1150000"
"4","3.75","4060","19290","4060","0","2002","1020000"
"4","2.5","2730","4800","2230","500","1909","980000"
"4","2.25","3160","34560","3160","0","1981","965000"
"3","2.5","2630","10100","1580","1050","1967","852500"
"4","2.5","2030","3905","1630","400","1926","831000"
"4","3.25","2050","5000","1370","680","1987","750000"
"4","2.5","2610","33206","2610","0","1988","743700"
"4","2.5","2800","246114","2800","0","1999","739000"
"4","3","3150","7778","3150","0","2000","700000"
"4","2.5","2350","63162","2350","0","1994","649950"
"4","2.5","2380","13435","2380","0","1992","648000"
"3","2.5","2140","8925","2140","0","1991","640000"
"4","2","2030","9300","2030","0","1976","627000"
"3","1.75","2210","16200","1390","820","1958","625000"
"3","2.5","2590","7237","2590","0","2004","620000"
"4","2.5","3190","7399","3190","0","2006","609900"
"3","2.5","2670","47480","2670","0","1981","605000"
"3","2.5","2630","77972","2630","0","2004","600000"
"4","3.5","3730","15029","2440","1290","1991","599950"
"4","1.75","2470","131790","2470","0","1937","585000"
"2","2","1870","6275","1870","0","2003","579000"
"3","1.75","2050","3520","1070","980","1977","568000"
"4","2.5","2800","12831","2800","0","2001","563500"
"3","1.5","2070","5386","1140","930","1948","559000"
"3","1.75","1760","10780","1760","0","1977","554000"
"2","2.5","1380","951","1380","0","2006","552000"
"3","2.5","2260","4165","2260","0","2005","550000"
"4","2.5","2700","5100","1440","1260","1968","550000"
"3","1.75","1380","3402","1380","0","1900","550000"
"3","2.5","1530","3464","1530","0","1998","546000"
"3","2.25","2190","7149","1240","950","1963","539950"
"3","2.5","1900","6224","1900","0","2005","536000"
"3","3","2470","36445","2470","0","1980","525000"
"3","1.75","1300","8800","1300","0","1963","502000"
"4","1.75","2240","9886","2240","0","1965","500000"
"3","3.5","1500","1249","1240","260","2004","489000"
"4","1.75","2220","6500","2220","0","1964","480000"
"4","2.75","1980","11443","1980","0","1952","475000"
"4","2.5","2330","9928","2330","0","1998","471000"
"3","1.75","1640","13500","1110","530","1940","450000"
"4","2.5","2170","14024","2170","0","1992","442500"
"3","1.75","2240","8153","1120","1120","1948","440000"
"3","2.25","1890","7200","1230","660","1973","435000"
"2","1","800","5000","800","0","1906","435000"
"3","2","1310","2550","780","530","1986","428000"
"2","1","910","6460","910","0","1905","425000"
"2","1","920","6600","920","0","1919","417000"
"3","1","1410","5060","910","500","1956","410000"
"3","2.5","1960","4400","1960","0","2006","410000"
"2","1","710","1136","710","0","1943","403950"
"2","1","1140","5100","1140","0","1942","400000"
"4","3.5","2370","3692","2370","0","2013","400000"
"3","2.5","1720","1715","1240","480","2004","398000"
"4","1.75","2700","7875","2700","0","1968","390000"
"3","1.75","1230","7500","1230","0","1987","385000"
"4","1.5","2020","7560","2020","0","1960","379000"
"2","1","730","7528","730","0","1946","378500"
"3","1.75","1710","10800","1710","0","1958","368000"
"4","2.75","2190","14937","2190","0","1993","367300"
"3","2.5","1800","2700","1800","0","2011","365000"
"3","3","2500","8304","2500","0","1997","364900"
"2","1.75","1060","1241","960","100","2008","352750"
"3","1.75","1240","8050","1240","0","1978","347000"
"3","2.5","1210","1420","1210","0","2008","345000"
"2","1.5","1340","1210","1120","220","2008","345000"
"4","1.75","1920","7665","1500","420","1975","341000"
"3","1.75","1440","45302","1440","0","1977","328000"
"3","2","1350","11805","1350","0","1986","325000"
"3","2.5","1480","1590","1150","330","2010","315000"
"4","2.5","1980","5909","1980","0","2003","307550"
"3","2","1590","35988","1590","0","1974","305100"
"2","1","740","5995","740","0","1949","304700"
"4","3","2390","4500","2390","0","1974","290000"
"3","1.5","1860","7963","1200","660","1963","288350"
"3","2.25","1680","35127","1680","0","1987","285000"
"2","1.75","1610","158558","1610","0","1948","280000"
"4","2.75","1990","7252","1270","720","1999","270000"
"2","1","1000","31505","1000","0","1960","265000"
"2","1","1200","9000","1200","0","1917","255000"
"3","2.25","2210","8000","2210","0","1969","250250"
"5","1.5","2520","5753","1510","1010","1928","250000"
"4","1","1910","16320","1910","0","1934","240000"
"3","1.75","1330","6301","1330","0","1998","236000"
"3","1","1590","13000","1590","0","1944","235000"
"3","1","1330","8912","1330","0","1948","234999"
"4","1.75","1300","21000","1300","0","1969","229950"
"3","1.5","1150","8686","1150","0","1963","213400"
"4","1.75","1980","9000","1480","500","1978","213000"
"2","2","1030","21712","1030","0","1938","212500"
"5","3.25","5270","17232","4010","1260","1977","1800000"
"4","2.5","3700","21755","2620","1080","1988","1250000"
"5","3","2830","7500","2460","370","1923","1240000"
"4","2.5","3040","5432","3040","0","2001","1230000"
"5","3.75","3630","6000","2470","1160","2004","1180000"
"3","3","2940","4622","2230","710","1988","1070000"
"5","3.25","3230","3825","2480","750","2014","1060000"
"5","4","3760","28040","3760","0","1983","1030000"
"6","3.75","2930","14980","2930","0","2013","915000"
"4","2.5","2580","3909","2580","0","2013","899900"
"5","2.5","2550","20875","1610","940","1953","895000"
"4","2.5","3340","12248","2470","870","1998","870000"
"3","2.25","1620","4500","1620","0","1926","800000"
"5","3.25","2750","7500","2150","600","1937","750000"
"3","1","1580","5000","1580","0","1926","749000"
"4","3.25","3490","7024","3490","0","2006","745000"
"3","2.5","3000","25341","3000","0","1995","740000"
"3","3.5","2440","3427","1990","450","2000","710000"
"3","2","2080","3880","1160","920","1954","700000"
"5","2.75","3100","9825","3100","0","1950","700000"
"3","2.75","2540","4694","2540","0","2005","695000"
"3","2.5","2550","45254","2550","0","2001","695000"
"4","3.5","3510","9364","3510","0","2001","695000"
"3","1.75","1760","8400","1460","300","1960","680000"
"3","1.75","1820","5500","1620","200","1957","659500"
"3","2.5","2510","6320","2510","0","1996","659000"
"3","1.75","2050","11856","1460","590","1962","655275"
"4","2.25","2560","9731","2560","0","1973","650000"
"4","2.75","2490","9714","1400","1090","1983","608000"
"4","4.5","3870","35889","2530","1340","2001","589900"
"4","2","2750","7807","2250","500","1916","571000"
"5","3","3670","10583","2060","1610","1952","569000"
"4","1.75","2440","5000","1340","1100","1954","566000"
"3","2.75","2340","16500","1500","840","1972","563000"
"4","2","2180","3870","1020","1160","1900","558000"
"3","2","2180","4976","1680","500","1930","555000"
"4","2.75","2790","8853","2790","0","2013","533112"
"5","2.75","2880","8364","2880","0","2006","525000"
"3","2","2110","5150","1080","1030","1919","516200"
"3","2.5","1800","5001","1800","0","1996","515000"
"3","2.5","2340","5957","2340","0","1995","505000"
"2","2.25","1060","1208","940","120","2005","499950"
"2","1","1220","3000","920","300","1926","499000"
"3","2","2220","10275","1640","580","1980","490000"
"4","2.5","3020","8302","3020","0","1994","490000"
"4","2","1210","11100","1210","0","1955","483300"
"4","1.75","2320","4322","1140","1180","1910","480000"
"5","2.5","2732","9500","1870","862","1975","480000"
"2","1.75","1490","224334","1490","0","1983","475000"
"3","1.75","2290","14800","1620","670","1965","470000"
"2","1","1470","7137","1020","450","1941","445434"
"3","1.5","1290","1286","1290","0","2000","440000"
"5","2.25","1970","15247","1450","520","1986","435000"
"3","1.75","1870","7189","1270","600","1959","433000"
"3","1.5","2010","9480","1570","440","1951","429950"
"3","3.25","1410","1246","1410","0","2005","429000"
"2","1","860","3880","860","0","1916","420000"
"4","1","1390","10800","1390","0","1941","417500"
"3","2.5","2090","6045","2090","0","2000","415000"
"2","1","1100","3598","1100","0","1926","403000"
"4","2.5","2530","7563","1440","1090","1978","400000"
"2","1","710","1157","710","0","1943","399950"
"4","2.75","1940","6555","1940","0","1990","392000"
"4","1.75","1720","8750","860","860","1971","385000"
"4","1.5","1680","11123","1130","550","1959","380000"
"3","1.5","1530","7200","1530","0","1975","375500"
"4","2.5","2210","9427","2210","0","1999","375000"
"4","2.5","1960","7133","1960","0","2002","369990"
"3","1.75","1520","8625","1520","0","1976","366000"
"4","2","1630","10375","1630","0","1968","360000"
"3","1.75","1890","9100","1890","0","1952","359950"
"2","0.75","1392","43710","1392","0","1978","350000"
"3","1.75","1540","6909","920","620","1955","345000"
"3","1.75","2430","9133","1410","1020","1978","335000"
"4","2.5","1930","9643","1930","0","1992","315000"
"2","1","1740","3622","950","790","1924","315000"
"3","1.75","1420","7650","1100","320","1984","310000"
"4","1","1740","11075","1740","0","1965","310000"
"3","2.5","1780","6771","1230","550","1990","310000"
"4","1","1150","8184","1150","0","1947","307000"
"2","1.5","1010","7719","1010","0","1981","306888"
"4","2.5","2009","5000","2009","0","2014","303210"
"2","2","1651","18200","1651","0","1946","285000"
"4","2.5","1940","6206","1940","0","1990","278500"
"3","2.5","1560","4200","1560","0","2003","269000"
"2","1","1380","5000","870","510","1943","268000"
"3","1.75","2040","7281","1020","1020","1962","253000"
"3","2","1320","7200","1320","0","1975","251750"
"3","1.75","1590","7560","1130","460","1984","250000"
"4","1","1200","7200","1200","0","1944","227000"
"3","1.75","1760","26055","920","840","1979","225000"
"3","1","970","7742","970","0","1967","219900"
"3","1","920","9812","920","0","1962","199500"
"3","1.75","1330","9200","1330","0","1973","183000"
"6","1.5","1930","8400","1030","900","1971","175000"
"3","1","970","6600","970","0","1965","165000"
"3","1","1010","9450","1010","0","1959","149500"
"4","1","1120","2685","860","260","1939","100000"
"5","4.5","10040","37325","7680","2360","1940","7060000"
"5","6.25","8670","64033","6120","2550","1965","2890000"
"3","2.5","2880","13500","1520","1360","1950","1990000"
"5","3.5","4210","17258","4210","0","1995","1370000"
"5","2.5","2340","6000","2340","0","1922","1090000"
"4","2.5","3760","29224","3760","0","1987","1010000"
"5","3","2510","4125","1590","920","1925","881000"
"4","2.5","3470","5414","3470","0","1995","875000"
"4","2.5","3320","11901","2650","670","1977","852600"
"3","2.5","2070","13241","1270","800","1910","850830"
"4","2.75","3370","6675","1920","1450","1948","813000"
"4","2.5","3280","6181","3280","0","2001","809950"
"4","3.75","2690","4000","2120","570","1909","800000"
"3","1.5","2210","6300","2210","0","1916","799000"
"3","3.5","4500","21870","4500","0","2004","785000"
"3","1.75","2430","14607","1230","1200","1949","762400"
"4","2.5","2810","10986","2810","0","1997","742000"
"4","2.75","2490","17833","1490","1000","1979","740000"
"4","1.75","2460","5100","1450","1010","1909","735000"
"5","2.75","3240","6863","3240","0","2013","719950"
"3","2.75","2500","7378","1390","1110","1948","700000"
"6","3","4250","4400","3020","1230","1902","665000"
"4","2.75","4140","24190","4140","0","2002","657500"
"2","1","1030","5750","1030","0","1928","650000"
"4","2","2090","3610","1790","300","1927","619400"
"5","2.75","2910","53898","1510","1400","1979","600000"
"4","2.5","2790","230868","2790","0","1989","599000"
"4","2","1680","5000","980","700","1950","588000"
"4","2.75","2240","27820","2240","0","1976","580379"
"3","2.5","2600","7465","2600","0","1988","571000"
"3","2.5","1990","3984","1990","0","2004","560200"
"3","3.5","1650","2262","1650","0","2010","547500"
"3","2.5","2180","15693","1850","330","1979","545000"
"2","1.25","1240","2150","1240","0","2014","545000"
"5","2.25","2520","49222","2520","0","1978","535000"
"3","1.75","1550","3680","1050","500","1927","530000"
"2","1.75","1640","4080","840","800","1921","527000"
"3","1.75","1730","8400","1400","330","1980","522000"
"4","3.5","2550","8698","2550","0","2007","516000"
"3","2.5","3370","19585","3200","170","1951","515000"
"3","1.75","1720","5899","1220","500","1986","514000"
"6","5","3440","4500","3280","160","2007","495000"
"2","1.5","1295","1093","1105","190","2007","487028"
"3","1","1140","5500","1140","0","1908","476000"
"3","2.25","1630","2520","1630","0","2005","475000"
"4","1.75","1470","5350","980","490","1955","465000"
"4","2.5","2090","9702","1320","770","1965","465000"
"4","2.5","2180","7203","2180","0","1989","464000"
"3","2","2060","4437","1030","1030","1929","460000"
"4","2.5","3170","10688","3170","0","2001","455000"
"4","2.5","2300","19250","2300","0","1955","450000"
"3","2.5","1420","2581","1420","0","2004","435000"
"4","1","1860","4736","1860","0","1901","427000"
"4","2.5","2550","4500","2550","0","2009","415000"
"3","2","1640","7201","1640","0","1948","405000"
"2","1","710","1131","710","0","1943","399950"
"3","1.5","1270","1318","1080","190","2004","386000"
"3","1.5","1460","11407","1460","0","1954","381000"
"3","2","1370","8336","1370","0","1964","371500"
"3","1","890","7200","890","0","1951","371000"
"1","1.75","750","20339","550","200","1946","355000"
"3","1","940","10368","940","0","1965","354000"
"3","1.75","1170","8182","1170","0","1962","352500"
"3","3.25","1460","1592","1130","330","2006","350000"
"3","2.5","1430","1002","1430","0","2002","349000"
"4","2.25","2030","13500","1230","800","1963","335000"
"2","1","720","6686","720","0","1942","333000"
"3","2.5","2210","7557","2210","0","1989","330000"
"3","2.5","2456","7566","2456","0","2012","329950"
"3","1.75","1790","27427","1130","660","1978","325000"
"3","1","1160","8813","1160","0","1952","317000"
"3","2.5","2250","7294","2250","0","1994","308900"
"5","3.5","2100","5107","1410","690","1999","295000"
"4","2.75","2414","7693","2414","0","2006","292000"
"2","1","860","3874","860","0","1931","290300"
"3","1.75","1520","15090","1520","0","1968","290000"
"3","2.5","1870","4060","1870","0","2005","285000"
"3","2.5","1860","6607","1860","0","1989","280000"
"2","1","1350","10096","1350","0","1952","276900"
"3","1.5","1160","8906","1160","0","1962","262500"
"2","1.5","982","846","806","176","2006","250000"
"5","1.5","1510","9078","1510","0","1959","248000"
"3","1.5","1360","9760","1360","0","1984","240000"
"3","2","1640","5280","1640","0","1910","234000"
"5","2","1910","7200","1110","800","1951","230000"
"3","1","1050","6300","1050","0","1942","220000"
"3","1.75","1570","4875","1310","260","1977","214950"
"2","1","700","4700","700","0","1953","200000"
"1","1","620","8261","620","0","1939","148000"
"2","1","800","15000","800","0","1927","110000"
"5","4.25","4860","9453","3100","1760","1905","2250000"
"4","2.5","3000","7500","3000","0","1937","1690000"
"4","3.75","4030","10800","4030","0","2006","1490000"
"5","2.25","3200","20158","1600","1600","1965","1330000"
"5","4","4410","14380","4410","0","2006","1240000"
"4","2.5","5730","44947","4280","1450","1991","1230000"
"4","2.5","3200","7500","1860","1340","1948","1180000"
"4","2.5","3270","35445","3270","0","1989","1070000"
"4","2.5","2370","10858","2370","0","2003","1030000"
"4","3.25","2420","4000","1870","550","1911","920000"
"4","2.25","2460","44431","2460","0","1957","900000"
"3","2.25","2060","8640","2060","0","1966","890000"
"4","3.25","3960","7012","3960","0","2005","860000"
"4","2.25","2130","11843","2130","0","1972","850000"
"3","3","2790","12523","1600","1190","1977","835000"
"4","2.5","2683","40386","2683","0","1987","822000"
"3","2","2420","17859","1500","920","1979","795000"
"4","2.5","3010","6100","3010","0","2005","789500"
"3","3.5","3950","111078","2460","1490","1989","784000"
"3","1.75","2110","11250","2110","0","1961","743000"
"3","2.5","2480","5137","2480","0","2000","717000"
"3","2.75","1900","6400","1410","490","1942","706000"
"4","2.5","3280","27441","3280","0","1996","699000"
"3","2.5","2570","3600","2570","0","2007","680000"
"3","2","2460","6600","1370","1090","1952","678500"
"3","2.5","2050","6420","1730","320","1956","670000"
"3","3","2340","2970","2160","180","1925","660000"
"4","2","2710","4750","1460","1250","1919","656500"
"5","3.5","3690","11928","2540","1150","2006","640000"
"2","1","1430","3000","1300","130","1929","620000"
"4","2.25","2180","7297","2180","0","1984","610750"
"3","2.25","1480","5400","1480","0","1914","600000"
"5","2.75","2820","4608","1450","1370","1967","599000"
"4","1.75","1870","5200","1200","670","1937","594000"
"3","2.5","1910","1501","1530","380","2007","585000"
"5","2","2060","6000","2060","0","1903","580000"
"4","2.5","3140","9225","1770","1370","1966","578000"
"2","1","1510","4032","1310","200","1935","575000"
"3","2.25","1710","4140","1710","0","2004","561000"
"4","1.75","1880","3880","1090","790","1944","560000"
"3","1","1510","5000","1510","0","1909","545000"
"3","2.5","2120","9736","2120","0","1988","531000"
"4","1","2080","3500","1260","820","1926","520000"
"3","1.75","1600","19200","1600","0","1967","510000"
"3","1.75","1970","7972","1370","600","1976","501000"
"5","2.75","2990","7420","2990","0","1996","498500"
"4","2.5","2140","7245","2140","0","2003","495000"
"3","2","1769","9300","1769","0","1955","495000"
"4","2.25","2640","31941","2640","0","1986","489950"
"4","2.5","2470","35073","2470","0","1989","485000"
"3","2.5","1250","1103","1250","0","2005","480000"
"5","2","1940","7642","1940","0","1957","465250"
"2","1.5","1630","3780","890","740","1940","448000"
"3","1","1050","5664","910","140","1947","445000"
"5","1.75","2460","6846","1340","1120","1911","445000"
"3","1","1210","5750","1210","0","1910","440000"
"3","1","1710","6556","1200","510","1926","440000"
"3","2.75","1560","7392","1030","530","1972","440000"
"4","1.75","1890","6000","1110","780","1947","430000"
"3","1","1330","15678","900","430","1984","405000"
"3","3.5","1240","1666","1000","240","2008","402000"
"3","1.75","1590","8219","970","620","1938","400000"
"3","1","1180","14258","1180","0","1948","397990"
"3","1.75","1800","6000","900","900","1950","381000"
"2","1","1220","17172","1220","0","1947","370000"
"3","3.25","1651","1779","1341","310","2008","363000"
"4","2.25","2300","4600","1340","960","1904","350000"
"3","1","1060","9525","1060","0","1966","349950"
"3","2","2080","11375","2080","0","2002","342500"
"2","2.25","1170","1011","1170","0","2009","336750"
"4","2.5","1910","9244","1910","0","1963","333000"
"2","1","1100","8281","1100","0","1947","320000"
"2","1","970","5665","970","0","1908","315000"
"3","2.5","1880","7000","1880","0","1993","315000"
"2","1.5","1070","1200","1070","0","1999","312500"
"5","3","1880","1716","1100","780","1997","310000"
"4","2.5","2490","8124","2490","0","2001","306000"
"3","3.25","1470","1235","1180","290","2008","300000"
"3","2.5","1970","7500","1970","0","1988","299995"
"3","2.5","2210","10119","1450","760","1966","299000"
"4","2.5","2210","8465","1490","720","1990","294000"
"1","0.75","420","6720","420","0","1922","280000"
"4","1.5","1490","7560","1490","0","1966","259000"
"4","2.5","1770","5855","1770","0","2003","248000"
"3","1.75","1840","9697","1500","340","1985","235000"
"2","1","910","9869","910","0","1957","223000"
"4","1.75","1200","7680","1200","0","1968","210000"
"4","1.5","1130","7840","1130","0","1970","210000"
"2","1","820","10450","820","0","1965","173000"
"3","2.5","4310","32093","2510","1800","1982","1740000"
"2","2.25","3170","3000","1990","1180","1900","1700000"
"5","2.25","4200","5800","2910","1290","1906","1340000"
"6","3.75","3010","4360","2000","1010","2014","1130000"
"5","1.5","2540","6660","2340","200","1954","1120000"
"4","2.5","2750","4800","1960","790","1905","1030000"
"5","2.75","3100","10014","1660","1440","1973","975000"
"4","2.5","3770","35081","3770","0","1989","950000"
"5","2.5","2350","9496","2350","0","1993","910000"
"4","2.25","2770","13500","2770","0","1974","890000"
"4","2.5","3670","54450","3670","0","1999","883000"
"4","2.5","4120","22370","4120","0","1997","863000"
"2","2","2280","641203","2280","0","1990","849900"
"4","2.75","4070","115434","4070","0","2002","845000"
"5","3.5","2320","4960","1720","600","1926","822500"
"3","1.75","1980","13503","1320","660","1952","810000"
"3","2.5","2860","4442","2860","0","2000","799000"
"4","3.5","3200","3250","2670","530","2007","795000"
"4","2","3140","10875","1940","1200","1939","775000"
"4","2.5","2420","10285","1700","720","1958","760000"
"5","2.5","3210","12000","1830","1380","1968","725000"
"3","2","2910","6600","1920","990","1900","718500"
"4","2.75","3650","48351","3650","0","1978","697000"
"3","2.5","2300","3060","1510","790","1930","696000"
"4","2.5","2790","43091","2790","0","1989","665000"
"5","2.75","3320","23760","2190","1130","1975","622500"
"3","1.75","2350","20820","1800","550","1978","615000"
"4","2.5","2010","7972","2010","0","1989","590000"
"4","3","2440","9600","2440","0","1961","589000"
"3","2","2250","8800","1250","1000","1925","589000"
"3","1","1870","2807","1580","290","1927","585000"
"3","2.5","2040","4627","2040","0","1992","580000"
"3","1.75","1760","12874","1230","530","1967","577000"
"3","3","1384","1287","1144","240","2006","575000"
"3","1.75","1640","7437","1090","550","1948","556000"
"5","3","3610","9775","3610","0","2003","540000"
"3","1","1460","7200","1260","200","1906","538000"
"3","1","1540","3399","1200","340","1926","530100"
"4","2.75","2020","7070","1010","1010","1958","513000"
"3","1","1830","3000","1430","400","1926","499950"
"3","2.5","1580","6065","1580","0","1985","485000"
"3","2.25","1580","12177","1200","380","1981","475000"
"3","1.75","1850","6869","1100","750","1919","459950"
"3","2","2020","8555","1220","800","1957","458000"
"4","2.25","2630","39000","2630","0","1979","454000"
"4","2.25","2010","7575","1220","790","1974","440000"
"3","1.75","1500","8173","1500","0","1997","435000"
"3","2","1910","5040","1910","0","1971","430000"
"4","2.5","2690","7947","2690","0","1993","419000"
"4","2.5","1750","4779","1750","0","2009","415500"
"3","2.25","1920","4833","1060","860","1921","385000"
"4","2.5","2050","5276","2050","0","2006","385000"
"4","2.5","2540","6365","1870","670","2000","380000"
"3","2.25","1410","1287","1290","120","2005","379500"
"2","1","900","4600","900","0","1951","370000"
"4","2.5","2220","5338","2220","0","2001","370000"
"3","1.5","1650","9957","1100","550","1961","369500"
"3","1.75","1820","9545","1230","590","1976","350000"
"2","1.5","1800","26615","1240","560","1987","345000"
"3","2.5","1070","1155","720","350","2005","330000"
"3","2.5","2070","8337","2070","0","1997","325000"
"4","2.5","1880","7965","1880","0","2000","324900"
"3","1.5","1210","5240","610","600","1983","305000"
"3","1","1280","8184","1280","0","1947","304000"
"4","2.5","2700","10814","1560","1140","1966","300000"
"3","1.75","1180","13927","1180","0","1962","299000"
"3","1.75","1840","8601","920","920","1905","285000"
"4","1.75","1900","10588","1900","0","1958","265000"
"4","2.5","1930","8660","1120","810","1981","250600"
"3","2.25","1400","3814","1400","0","2012","250000"
"3","1.75","1900","8540","950","950","1980","235000"
"2","1","930","7550","930","0","1986","230000"
"2","1","710","7200","710","0","1943","215000"
"2","1.75","1440","5680","1440","0","1978","210000"
"3","1","1340","11070","1340","0","1978","206135"
"3","1","1290","6566","1290","0","1976","205000"
"4","2","1520","19672","1020","500","1920","171000"
"3","1","1270","6405","1270","0","1944","153000"
"2","1","1150","30184","1150","0","1950","129000"
"4","2.5","2960","41656","2960","0","1985","883000"
"5","2.75","2920","11880","1660","1260","1968","850000"
"4","2.75","2450","4187","2450","0","2010","735000"
"3","2.5","1930","7214","1930","0","2005","530000"
"4","2.75","2360","4924","2360","0","2008","525000"
"2","1","1980","5000","1090","890","1923","496752"
"3","2","1510","6710","1070","440","1972","397500"
"3","1.75","1430","8865","1430","0","1950","330000"
"4","3.25","2500","5801","1960","540","1926","1140000"
"4","2.5","2700","9122","2700","0","1990","652500"
"3","1.75","2140","9484","1290","850","1953","650000"
"3","2","1900","8100","950","950","1940","520500"
"5","3","2430","8000","1370","1060","1957","506000"
"3","1","1110","12150","1110","0","1957","416000"
"3","2.5","1890","4838","1730","160","2002","269950"
"4","2.5","3070","34412","2070","1000","1950","1920000"
"4","2.25","3040","5000","2080","960","1926","1740000"
"3","3.25","2940","5432","2440","500","1978","1710000"
"4","4","3530","8400","2630","900","1958","1100000"
"4","2.75","2800","19168","2800","0","1992","999000"
"4","3.5","3280","6603","3280","0","2007","963000"
"4","1.5","2220","9496","1490","730","1954","921000"
"4","2.5","3030","8507","3030","0","2003","902000"
"4","3.5","3290","5414","2360","930","2006","899950"
"4","2.5","3190","14565","3190","0","1990","862000"
"4","3.25","3450","6184","3450","0","2014","852880"
"4","3.5","4140","7089","3160","980","2003","850000"
"4","1.5","1890","6938","1890","0","1919","825000"
"4","2.5","2810","9800","1710","1100","1973","825000"
"3","2.75","2670","3738","1720","950","2013","798800"
"4","2.5","4290","175421","4290","0","2004","792500"
"3","1.75","1990","5560","1100","890","1939","763101"
"3","2.5","3100","23790","3100","0","2002","759950"
"4","3.25","3430","9870","3430","0","2014","749995"
"4","3.5","2690","6164","2690","0","2002","699850"
"2","1.75","1600","4000","850","750","1918","690000"
"4","3.5","2840","4637","2840","0","2008","685000"
"4","2.75","2500","4950","2500","0","2010","680000"
"3","1.5","1720","8100","1720","0","1907","667000"
"6","1.75","1840","2774","1060","780","1900","660000"
"4","2.75","2610","4160","1910","700","1910","650000"
"3","2.5","2110","3600","2110","0","2005","638000"
"5","2.5","2640","7096","2640","0","2003","632500"
"4","2.5","2440","28405","2440","0","2002","576000"
"4","2.5","2120","9603","2120","0","1985","575000"
"4","2.25","2170","7737","2170","0","1987","566000"
"4","2.75","3130","139392","3130","0","1981","565000"
"3","3.5","3380","108900","2700","680","1999","554000"
"3","1","1120","2300","820","300","1912","552000"
"3","2.5","1940","9775","1440","500","1975","545000"
"4","2.5","2650","5600","2650","0","2014","542525"
"3","2.5","1700","3150","1700","0","2005","534500"
"4","2.5","2050","6360","2050","0","1988","530000"
"2","1","1120","2000","1120","0","1910","524000"
"3","2.25","1420","1282","1420","0","2006","523950"
"4","2.5","1740","7500","1220","520","1976","518000"
"4","2.75","2280","54014","2280","0","1960","500000"
"3","1.75","1540","10800","770","770","1947","500000"
"3","1.75","1750","12325","1470","280","1968","499000"
"5","2.5","2570","9962","2570","0","2006","492500"
"3","1.5","1510","8000","1510","0","1956","470000"
"3","1.5","1760","6723","1160","600","1958","470000"
"3","2.5","1350","13457","1120","230","2007","468500"
"3","2.25","2670","7500","1640","1030","1966","465000"
"3","1.75","1550","4708","860","690","1949","460000"
"2","1.5","1090","4000","970","120","1951","460000"
"2","1","890","2100","760","130","1919","460000"
"2","1.5","1310","12196","1310","0","1970","455000"
"6","2.25","3550","11780","2960","590","1948","450000"
"3","1.75","1890","32340","1890","0","1976","445000"
"3","2.5","2300","9521","2300","0","2003","435000"
"3","2","1980","2674","1980","0","2007","435000"
"5","2.5","2340","4500","2340","0","2009","429000"
"3","2.5","1830","65340","1520","310","1991","427000"
"4","3","2360","6250","1460","900","1960","418000"
"4","1.5","1220","10580","1220","0","1965","418000"
"4","2","1800","2970","1000","800","1923","415000"
"4","2","1580","9581","1580","0","1953","410000"
"4","1.75","1580","5340","1130","450","1947","400000"
"4","1.75","1690","4080","870","820","1984","385000"
"3","2","1590","9912","1590","0","2000","385000"
"4","2.5","2960","5054","2960","0","2006","385000"
"2","1","830","26329","830","0","1928","385000"
"5","2.5","2760","8015","1600","1160","1960","378000"
"4","2","1240","3000","1040","200","1908","375000"
"4","2","2400","6000","2400","0","1913","375000"
"4","2.5","2040","109336","2040","0","1973","375000"
"3","1","1770","5720","1140","630","1926","373000"
"3","2","1530","8925","1530","0","1977","371025"
"2","1.75","1210","1040","1210","0","2014","357186"
"4","2.25","1760","9602","1760","0","1987","353500"
"3","2.5","1212","1174","1212","0","2004","340000"
"3","1.5","2040","6000","1340","700","1957","335000"
"1","1","960","2640","760","200","1908","332000"
"3","2.25","1200","1400","1200","0","2005","320000"
"3","1.75","1150","9600","1150","0","1979","309212"
"4","2","1810","8750","1110","700","1967","304000"
"5","3","1940","6355","1200","740","2007","300000"
"3","1.75","1770","8235","1030","740","1960","295000"
"4","1.75","1960","7950","1960","0","1967","285500"
"3","2.5","1880","6008","1880","0","2009","284000"
"3","1","1100","9253","1100","0","1957","277000"
"3","1","1000","9150","1000","0","1969","265000"
"2","1","1200","4880","980","220","1943","245000"
"2","1.5","880","1805","880","0","1999","235000"
"3","1.75","1400","6956","1400","0","1957","230000"
"4","2.5","2240","9826","1370","870","1988","220000"
"3","2","1410","7998","1410","0","1940","220000"
"3","1.75","1070","8100","1070","0","1957","183000"
"3","1.5","1220","7300","1220","0","1973","175000"
"3","1.5","1230","8056","1230","0","1949","150000"
"2","1","760","5500","760","0","1947","92000"
"5","6.75","9640","13068","4820","4820","1983","4670000"
"3","3.25","4340","4947","3060","1280","1993","2480000"
"4","3.75","4100","9050","2540","1560","1934","2030000"
"4","3","3700","20570","1850","1850","1976","1730000"
"3","3.5","4360","6240","2960","1400","2008","1560000"
"3","2.25","2880","7599","1710","1170","1958","1540000"
"4","4","4420","16526","4420","0","2013","1330000"
"4","3.5","4170","9748","4170","0","2004","1200000"
"3","2.75","2500","5568","2500","0","1905","1190000"
"4","2.5","2570","6251","2570","0","2000","1170000"
"3","3.25","2420","1923","1840","580","2006","1010000"
"4","3.5","2650","3060","2060","590","2001","1010000"
"3","2.75","2750","18029","1810","940","1978","950000"
"3","1.75","2960","12420","1480","1480","1952","936000"
"5","3.75","3870","8225","3870","0","1998","900000"
"4","4.25","3010","4887","1940","1070","1951","870000"
"5","3.5","3130","4797","2570","560","2014","866059"
"4","2.75","3150","38865","2480","670","1986","854000"
"4","3.5","3860","18334","3120","740","1996","840000"
"5","2.75","3010","12611","3010","0","1994","837700"
"7","4.25","3670","4000","2800","870","1964","824000"
"3","2.5","2670","10481","2670","0","2003","810000"
"3","2.5","2590","7720","2590","0","1988","809000"
"3","2","1570","7000","1050","520","1971","765000"
"4","2.5","2940","10382","2940","0","1991","752000"
"3","2.5","2300","6009","2300","0","2005","738500"
"3","1","1580","3840","1580","0","1908","729000"
"4","2.75","2630","7505","2630","0","1994","725000"
"4","2.5","2650","11520","2110","540","1988","720000"
"6","1.75","2740","6360","1370","1370","1953","675000"
"4","2.75","2700","35362","2700","0","1976","669000"
"3","2","1880","3800","1030","850","1927","667500"
"3","2","1380","4800","1380","0","1948","640000"
"4","2.5","2490","12929","2490","0","1983","616000"
"3","2.5","2830","6536","2830","0","1989","605500"
"3","2.25","2010","10760","2010","0","1985","605000"
"5","2","2700","10875","1540","1160","1962","580000"
"5","1","1710","9100","1320","390","1926","560000"
"3","2","2340","3477","1170","1170","1971","560000"
"4","1","1120","7104","1120","0","1946","554000"
"3","1.75","2240","78225","2240","0","1976","550000"
"2","2.5","1380","953","1380","0","2006","549000"
"4","1","1720","2800","1200","520","1926","547000"
"4","2.25","2030","11585","1590","440","1967","545000"
"4","2.25","1990","5948","1990","0","1991","536000"
"4","2.75","3070","7201","3070","0","2006","535000"
"4","2.5","3250","4500","3250","0","2009","519000"
"3","1.75","2180","7700","1480","700","1961","506000"
"3","2.5","2970","21907","2970","0","1998","499500"
"4","1.75","2030","18295","2030","0","1975","493000"
"3","2.75","2300","4637","2300","0","2008","479500"
"2","2.25","1230","932","1020","210","2004","479000"
"3","2.25","2280","5750","1150","1130","1985","475000"
"2","1","900","5100","900","0","1909","473000"
"3","2.5","1180","1262","1180","0","2010","472000"
"4","2.5","2340","6896","2340","0","2001","465950"
"2","2.75","1430","1425","995","435","2006","465000"
"2","2","1494","19271","1494","0","1943","465000"
"4","1.5","1550","3000","1350","200","1918","458000"
"4","2.5","1670","3315","1670","0","2005","451000"
"4","2.5","2470","3811","2470","0","1999","449950"
"4","2","1450","8400","1450","0","1962","440000"
"2","1","1230","3800","1230","0","1928","435000"
"3","2.25","1230","1238","1080","150","2009","435000"
"3","2","1730","9000","1370","360","1978","430000"
"3","1","980","7200","980","0","1950","430000"
"3","2.5","2890","21780","2890","0","2000","421000"
"4","2","1610","9600","1610","0","1967","415000"
"3","1.5","1880","7400","1480","400","1968","405000"
"3","1.5","1450","7375","1010","440","1968","402000"
"3","2.25","2140","11266","2140","0","1986","400000"
"2","2.5","1620","3196","1620","0","2008","386000"
"4","2.5","2210","7079","2210","0","1993","382500"
"4","2.5","2150","37647","2150","0","1991","380000"
"5","3.5","2800","7350","2800","0","1995","379900"
"3","1.75","1160","22470","1160","0","1976","375000"
"3","2","1380","3600","1380","0","2015","350000"
"2","2.5","1260","1347","1260","0","2005","350000"
"4","2.75","2250","7412","1480","770","1975","345000"
"3","2.5","1680","2229","1680","0","2007","345000"
"3","2.5","1270","2509","1270","0","2004","343000"
"2","1","740","9134","740","0","1948","342000"
"3","2.5","1530","9406","1270","260","1993","332000"
"3","2.5","3040","4548","3040","0","2003","330000"
"4","2.5","2610","7091","2610","0","1987","325000"
"3","1","860","5060","860","0","1927","320000"
"4","2","1870","6000","1870","0","1956","310000"
"3","2.25","2110","7665","1360","750","1973","305000"
"4","2.5","1660","9760","1660","0","1994","294999"
"3","2.5","1413","3600","1413","0","2011","286800"
"4","2.25","1930","7207","1360","570","1988","280000"
"3","2","1380","7476","1380","0","1989","272000"
"2","1.5","1480","7276","940","540","1978","269500"
"3","1.75","1440","12888","1090","350","1958","260000"
"3","1.5","1270","20700","1150","120","1948","260000"
"3","2","1870","5909","1270","600","1986","259000"
"3","1.75","1700","7532","1700","0","1987","255000"
"3","1.5","880","6600","880","0","1945","253000"
"2","1.5","1088","1360","1088","0","1983","250000"
"4","2.5","1800","8100","1800","0","1998","250000"
"3","1.75","1160","6134","1160","0","1998","250000"
"3","1.75","1370","8719","1370","0","1982","247200"
"3","1.75","1280","7524","1280","0","1988","242000"
"3","1","1140","8366","1140","0","1943","239950"
"3","1.75","1190","7280","1190","0","1968","235000"
"3","2","1410","7466","1410","0","1983","229950"
"1","1","930","7129","930","0","1948","210000"
"3","1","1320","7000","1320","0","1967","206000"
"4","1.75","1740","9344","1180","560","1978","204950"
"3","1.5","1430","7347","820","610","1980","198000"
"3","1.5","1180","7000","1180","0","1977","187500"
"4","1","1920","13787","1220","700","1966","170000"
"4","0.75","1440","13300","1440","0","1948","142500"
"4","3","6430","27517","6430","0","2001","4490000"
"4","4.25","4850","12445","3850","1000","1989","3000000"
"6","5","6050","230652","6050","0","2001","1600000"
"3","2","2020","5500","1790","230","1937","1400000"
"4","2.75","3870","10046","3870","0","2005","1400000"
"4","3.25","4290","12103","2690","1600","1997","1380000"
"4","3.5","4680","9700","3360","1320","2005","1160000"
"4","2.5","4270","43386","2680","1590","1991","975000"
"4","2.5","3640","10576","3640","0","1999","913000"
"6","3","3020","13783","3020","0","1952","900000"
"4","2.25","2190","4080","1800","390","1918","855000"
"5","3.5","3450","28324","2350","1100","1972","850000"
"4","3.5","3810","9792","3810","0","1938","825000"
"4","2.5","3170","8523","3170","0","2008","820000"
"3","2.25","2910","10204","2910","0","1990","770000"
"4","2.5","3210","14910","3210","0","1995","770000"
"4","2.5","2790","7938","2790","0","1997","764000"
"3","2.5","2420","43177","1690","730","1989","739888"
"4","1.75","1980","10800","990","990","1948","711000"
"3","3.25","1540","1428","1540","0","2013","690000"
"3","3","3450","16200","3450","0","1983","688000"
"5","1.75","1260","4500","1260","0","1926","650000"
"3","1.75","2920","9370","1620","1300","1981","650000"
"3","1.5","1320","8114","1320","0","1951","650000"
"5","2.75","2870","4461","1650","1220","1976","646000"
"4","2.5","2807","9430","2807","0","1996","630000"
"4","2.5","1910","7683","1910","0","1987","620000"
"5","2.25","2480","12070","2480","0","1978","615000"
"4","2.5","3250","5000","3250","0","2008","580000"
"5","3.25","3160","10000","3160","0","1980","574950"
"4","2.5","2290","6738","2290","0","1996","570000"
"5","3.5","3260","58806","3260","0","1969","568450"
"2","2","1690","4500","1690","0","2004","564000"
"5","3","2795","15101","2795","0","1996","562000"
"2","1","1240","6400","1060","180","1938","559000"
"3","1.75","2040","6000","1120","920","1958","555000"
"5","2.25","1870","11411","1170","700","1961","554000"
"3","2.5","1560","9361","1360","200","1936","545500"
"4","2.5","2050","34222","2050","0","1989","540000"
"3","1.75","1970","8200","1420","550","1963","540000"
"3","1.75","1930","6360","1930","0","2013","536751"
"3","2","2120","4080","2120","0","2003","535000"
"4","2.5","2610","4595","2610","0","2008","535000"
"4","2.5","2920","7700","2920","0","2003","515500"
"3","3.5","1360","1419","1040","320","2007","515000"
"5","3.25","3850","16249","3030","820","2002","507000"
"4","1.75","1770","9375","1170","600","1968","507000"
"2","2.5","1430","923","1410","20","2008","485000"
"3","3.25","1380","1120","1380","0","2008","482000"
"3","1.75","1700","8432","1230","470","1977","475000"
"5","2.5","2240","7543","1140","1100","1966","469000"
"3","1.75","1510","4800","860","650","1925","465000"
"3","3.25","2770","6278","1980","790","2006","461000"
"3","1.75","1180","14292","1180","0","1981","455000"
"3","1.75","1180","4080","760","420","1928","450000"
"4","2.5","2410","4780","2410","0","2000","440000"
"3","2","1670","7700","1170","500","1972","424000"
"3","1.75","1270","4800","1270","0","1952","415000"
"4","2.5","2020","5501","2020","0","2010","415000"
"4","2","1970","10500","1820","150","1961","410000"
"4","1.5","2310","68824","2310","0","1968","407450"
"5","2.5","3600","17300","2410","1190","1968","403500"
"3","1.75","1050","6150","950","100","1928","400000"
"3","3.25","1689","1388","1689","0","2008","384400"
"2","1","940","9839","940","0","1910","375000"
"3","2.5","1950","6871","1950","0","1997","375000"
"3","2.5","2640","6715","1680","960","1991","365000"
"2","1","1100","4200","1100","0","1954","343566"
"3","2.5","1600","26977","1600","0","2005","330000"
"3","2.75","2200","7000","1280","920","1977","325000"
"4","2.5","1820","6753","1820","0","1994","322500"
"3","2.5","1730","6368","1730","0","1993","315000"
"4","2.5","2660","12672","1740","920","1960","310000"
"3","2.25","1490","1294","1220","270","2010","309000"
"3","2.5","1700","3575","1700","0","2000","300000"
"3","1","910","7700","910","0","1971","300000"
"5","2.5","2220","9360","1110","1110","1968","299000"
"3","2","1380","8682","1380","0","1966","295000"
"4","2.5","2570","9000","1590","980","1979","287500"
"3","1","990","10723","990","0","1960","284950"
"5","1.75","2150","7171","1460","690","1970","279950"
"3","2.25","1720","9000","1320","400","1969","274500"
"3","2.25","1584","2800","1584","0","2012","267000"
"4","1.5","2050","7100","1050","1000","1963","265000"
"4","1.75","1770","9011","1050","720","1983","264950"
"4","1.75","1820","8118","1080","740","1980","264000"
"4","2","2030","9600","1430","600","1947","253779"
"2","1","790","11234","790","0","1942","250275"
"3","2","1260","8092","1260","0","1986","242000"
"2","1","670","10920","670","0","1942","240000"
"3","1.75","1670","6900","1170","500","1978","239950"
"2","1","1080","9435","1080","0","1958","230000"
"3","1","1130","12519","1130","0","1958","220000"
"2","1.5","1820","8867","1820","0","1921","206000"
"3","1","1080","8580","1080","0","1900","192500"
"1","1","720","4800","720","0","1914","190000"
"3","2.25","1990","6350","1990","0","1967","180000"
"2","1","660","5000","660","0","1915","175000"
"6","1","1370","5080","1120","250","1931","175000"
"5","4.75","5990","10450","4050","1940","2002","2200000"
"5","3","3880","13000","3880","0","1972","1820000"
"4","3.25","3620","5131","2350","1270","1927","1530000"
"3","3.5","3870","3819","2760","1110","2002","1440000"
"4","2.5","2440","3600","2440","0","1902","1330000"
"4","4.5","4750","13912","3600","1150","2005","1310000"
"4","3.5","3820","13224","3280","540","1990","1240000"
"5","3","3330","19126","2610","720","1977","1190000"
"5","3.5","3990","9938","3990","0","2001","1070000"
"3","2.5","2430","10500","2430","0","1989","1030000"
"2","2.5","2540","7089","2540","0","2004","945000"
"5","2","3530","9385","3530","0","1925","930000"
"4","2.5","3280","209088","3280","0","1994","925000"
"4","2.25","2370","6000","1440","930","1959","899000"
"2","1.75","1590","5136","1320","270","1927","850000"
"3","3","3910","19023","3910","0","1985","805000"
"4","2.5","2590","7910","2590","0","2001","799000"
"4","2.75","3010","15992","3010","0","1996","775000"
"3","2.5","2650","40705","2650","0","1994","770000"
"4","2.25","2160","5600","1080","1080","1947","756000"
"3","3.5","3390","10078","3040","350","2012","750000"
"4","2.5","2650","6884","2650","0","2012","734990"
"3","2.5","2320","6775","2320","0","2008","728050"
"4","2.5","2440","34290","2440","0","1987","720000"
"3","2.75","3200","6699","3200","0","2004","712000"
"3","2","1360","5980","1360","0","1945","703000"
"6","2","1670","3000","900","770","1911","680000"
"4","2.5","2496","8058","2496","0","1998","661000"
"4","3","2620","18362","1870","750","1956","659500"
"4","2.5","2310","4079","2310","0","2008","646000"
"4","2.5","2270","9247","1500","770","1972","619850"
"4","3.25","2520","3360","1550","970","1931","618250"
"3","3.25","1530","1612","1530","0","2006","607500"
"3","2","2540","237402","2540","0","2007","600000"
"4","2.25","3070","8400","3070","0","1970","600000"
"3","1.5","1470","7200","1470","0","1907","590300"
"4","2.5","2840","11044","2840","0","2001","585000"
"4","2.25","2160","9593","2160","0","1969","580000"
"3","2.5","1940","9000","970","970","1948","576000"
"4","2.25","2060","10358","1320","740","1962","558000"
"4","1.75","1290","3060","1290","0","1906","549000"
"3","2.25","1240","949","1240","0","2008","543000"
"5","3.75","3090","7415","3090","0","2014","540500"
"3","1.75","1940","219527","1940","0","1991","520000"
"3","2.75","2020","10744","1270","750","1954","519000"
"4","2.5","2610","8031","2610","0","1998","510000"
"3","2.5","2120","7201","2120","0","2003","507000"
"2","1","1570","8210","1150","420","1952","506000"
"3","2.5","1610","4611","1610","0","1996","505000"
"3","2.5","2840","48716","1870","970","1994","500000"
"3","1.75","1840","5000","920","920","1910","499000"
"3","2.25","1820","7326","1820","0","1983","489950"
"3","2.5","950","1110","950","0","2003","475000"
"3","2","1730","38884","1730","0","1997","470000"
"3","1","1320","3625","1320","0","1900","464000"
"3","1.75","1610","11200","1610","0","1955","450000"
"4","2.5","2400","7693","2400","0","2003","450000"
"3","1.75","1170","8740","1170","0","1968","440000"
"2","1.75","1440","4225","1440","0","2005","437000"
"2","1","790","6600","790","0","1949","436000"
"3","1.75","1310","8065","1310","0","1948","435000"
"4","2.5","2640","8625","2640","0","1987","429900"
"6","2.75","2520","9324","1320","1200","1962","410000"
"2","1","1260","4377","1260","0","1947","405000"
"4","1","1940","5753","1940","0","1947","401000"
"4","2.25","1820","8255","1320","500","1930","399888"
"4","1","1980","10350","1430","550","1968","395000"
"3","2.25","1600","10240","1090","510","1979","390000"
"3","1.75","2310","11200","1630","680","1978","385000"
"4","2.25","2150","20181","1090","1060","1963","380000"
"3","2.5","2160","3000","1260","900","1909","378750"
"3","2.5","1800","2700","1800","0","2011","362500"
"4","2.5","2850","4650","2850","0","2004","360000"
"3","2","1430","6000","1430","0","1945","352450"
"2","1","1620","9205","850","770","1921","350000"
"3","2","2140","7200","1480","660","1966","346150"
"3","2.5","2480","6112","2480","0","2004","340000"
"4","2","2030","103672","2030","0","1969","335000"
"3","2.5","2238","7209","2238","0","2011","330000"
"4","2.5","3490","5000","3490","0","2003","320000"
"2","1","920","8341","920","0","1939","319950"
"3","1.75","1900","3000","1070","830","1903","311000"
"4","1.5","1220","9600","1220","0","1980","310000"
"3","2","1300","11374","1300","0","1933","287000"
"3","1","1210","4731","1210","0","1901","285000"
"3","2","1790","42399","1790","0","1990","280000"
"3","1.75","1860","15681","1860","0","1971","275000"
"4","1.75","1530","8750","1530","0","1968","269900"
"3","1.75","1840","7300","1840","0","1966","265000"
"3","1","1050","8498","1050","0","1959","249000"
"4","2","2080","13510","1040","1040","1950","248000"
"4","2","1790","14690","1670","120","1960","240000"
"3","1.75","1750","11461","1750","0","1976","232603"
"3","1","1320","8450","880","440","1961","232500"
"3","2.25","1640","7350","1140","500","1984","221000"
"3","2","1440","7210","1440","0","1983","210000"
"3","1.5","1140","8340","1140","0","1960","200000"
"3","1","1330","5412","1330","0","1905","197500"
"3","2","1340","4320","920","420","1912","186000"
"3","1.75","1150","8079","1150","0","1983","177000"
"2","1","990","39964","990","0","1945","120000"
"6","4.5","5480","10800","4430","1050","1999","2400000"
"3","2.25","3230","17833","3230","0","1973","2110000"
"7","3.5","4640","15235","2860","1780","1965","1950000"
"5","3.25","3840","4800","2750","1090","2008","1460000"
"4","2.25","2870","6280","1980","890","1905","1330000"
"4","3.5","4410","36200","4410","0","1989","1320000"
"5","4","3366","7800","2966","400","1937","1300000"
"7","5.5","6630","13782","4930","1700","2004","1240000"
"5","3.25","3240","6551","2500","740","1939","1230000"
"6","4.25","6900","244716","4820","2080","2002","1140000"
"3","3","4910","43560","4000","910","1989","1080000"
"4","4.5","3850","13551","3000","850","1998","995000"
"3","1.5","1700","14133","1700","0","1954","979000"
"3","2.75","2470","10125","2470","0","1960","970500"
"4","2.5","3360","11548","3360","0","1988","950000"
"3","3.25","3050","18892","1650","1400","1962","950000"
"4","2","3140","10437","2040","1100","1959","925000"
"4","2.75","3730","8014","3730","0","2012","925000"
"3","3.25","2660","4000","2170","490","2003","915000"
"4","3.5","2970","14486","2340","630","1997","905000"
"3","2.25","2060","9552","1610","450","1975","885000"
"4","3","3740","30884","3060","680","1988","869000"
"3","2.25","2870","8170","2250","620","1995","850000"
"5","2.25","2780","10192","2780","0","1978","830000"
"3","3.25","3240","8338","3240","0","2001","812000"
"4","2.75","3150","7035","3150","0","2004","800000"
"4","1.75","2050","10920","1450","600","1974","790000"
"3","2.25","2140","3000","2140","0","1905","780000"
"4","2.5","2970","4400","2970","0","2014","775950"
"2","2.5","2770","7781","2770","0","2006","754800"
"4","3.25","3940","27591","3440","500","2000","725000"
"6","1.75","2380","4080","2380","0","1917","725000"
"3","3.5","3690","8837","3690","0","2001","725000"
"4","2.5","3290","6628","3290","0","2003","715000"
"5","2.75","3260","11700","1630","1630","1964","681500"
"4","2.25","2870","5453","2220","650","1926","665900"
"4","3.25","3030","9273","3030","0","1988","660000"
"3","3.25","1530","1565","1280","250","2005","654000"
"4","2.5","3040","6587","3040","0","2003","650000"
"2","1.75","1760","4400","880","880","1930","640000"
"4","2.5","2090","10306","2090","0","1986","632500"
"3","2.5","2440","4800","2440","0","2014","625000"
"3","2.5","1850","7777","1850","0","1989","623000"
"4","2.5","2620","7553","2620","0","1996","605000"
"2","1","1040","3600","1040","0","1919","600000"
"3","2.75","3290","22649","3290","0","1993","595000"
"3","3.5","1890","1710","1640","250","1999","587206"
"4","2.75","3260","4900","3260","0","2013","565000"
"5","2.5","2200","4080","1420","780","1916","547000"
"3","2.25","1750","1879","1750","0","2001","525000"
"4","1","1360","6000","1360","0","1917","511500"
"4","2","2120","11479","1060","1060","1940","489000"
"4","2.25","2170","9665","1300","870","1976","488800"
"4","3","1630","6250","1110","520","1990","482500"
"4","1","2080","5500","1040","1040","1941","480000"
"3","1.75","1780","8085","1210","570","1976","477000"
"3","2.5","1870","5013","1870","0","2003","458000"
"3","1.5","1440","28516","1440","0","1975","456000"
"3","2.25","1470","4653","1470","0","1985","455000"
"4","2.25","2450","21000","1650","800","1954","455000"
"3","2","1430","3480","980","450","1947","450000"
"4","2.5","2510","6853","2510","0","2006","448000"
"4","2.5","2040","21781","2040","0","1994","443500"
"3","2.75","1910","7280","1160","750","1979","441000"
"5","3","3110","12429","1790","1320","1977","436500"
"3","2.5","2540","5612","2540","0","1999","425000"
"3","2.25","1790","10209","1290","500","1967","425000"
"5","2.75","2280","10319","1300","980","1959","420000"
"5","3","2630","3149","1670","960","2013","420000"
"2","1","1260","3960","690","570","1925","412000"
"3","1","1460","10000","1460","0","2002","405000"
"3","1","1430","10005","1430","0","1950","400000"
"4","1.75","2670","189486","2670","0","1972","400000"
"4","2.25","2420","7927","1400","1020","1973","400000"
"4","2.5","2320","11717","2320","0","1997","397000"
"3","1","1500","4000","900","600","1925","395000"
"3","1","1160","3750","1160","0","1910","390000"
"3","1.5","1520","4288","1020","500","1949","380000"
"4","2.5","1890","12236","1230","660","1978","378000"
"4","2.5","2550","4770","2550","0","2005","371000"
"3","2.25","1940","11612","1100","840","1981","359950"
"5","2.25","2290","7420","1290","1000","1973","359900"
"4","2.5","2040","8265","2040","0","1996","355000"
"2","1","1240","10800","1000","240","1943","355000"
"3","1.75","1880","11249","1330","550","1985","340000"
"3","2.5","2570","4600","2570","0","2014","339990"
"4","3","2240","8504","2240","0","1992","337000"
"3","2","1510","7884","1510","0","1942","332000"
"3","2.25","1860","11227","1860","0","1995","330000"
"3","2.5","1820","8085","1820","0","1983","329950"
"2","1","840","4239","840","0","1948","325000"
"3","1.5","1860","60960","1140","720","1967","291000"
"4","2","1890","6302","1890","0","1997","282000"
"3","2","1470","8089","1470","0","1987","280000"
"4","2","2200","7700","1100","1100","1979","279000"
"4","1","1810","7500","1410","400","1959","264950"
"1","1","800","16306","680","120","1931","250000"
"1","0.75","380","15000","380","0","1963","245000"
"3","1","1300","8160","1300","0","1960","237000"
"2","2","1310","2841","1310","0","2004","218000"
"4","2.5","1960","11600","980","980","1931","215000"
"2","2","1680","5756","1680","0","1910","210000"
"3","1","960","7314","960","0","1960","205000"
"3","1","1150","7156","1150","0","1953","203000"
"3","2.25","1230","7420","1230","0","1913","200000"
"2","1","860","6600","860","0","1949","200000"
"2","1","1020","5130","1020","0","1948","175000"
"3","2.5","2200","20000","1400","800","1952","1100000"
"3","2.5","3290","6830","3290","0","2000","930000"
"4","2","2160","6300","2160","0","1928","849000"
"3","1.75","2610","5544","1680","930","1934","750000"
"4","2.25","2330","8994","2330","0","1986","639500"
"4","1.75","1780","2788","890","890","1943","442900"
"4","1.5","1550","9176","1000","550","1956","418000"
"2","1","1230","1820","830","400","1948","375000"
"4","3.5","3530","14406","2570","960","1987","874150"
"4","2.5","2810","10613","2810","0","1989","810000"
"3","1.75","2870","5000","1840","1030","1907","802000"
"4","2.5","2130","7300","1230","900","1963","732600"
"4","2.5","2370","10083","2370","0","1966","687000"
"2","1.75","1330","6000","960","370","1914","565000"
"4","2.5","2090","6023","2090","0","1990","545000"
"4","2.5","2040","8400","1420","620","1963","500000"
"2","2.25","1490","6770","1490","0","1926","480000"
"3","2.5","2050","40003","1570","480","1977","439500"
"4","2.5","2580","6260","2580","0","2004","374000"
"4","2.5","2380","13550","2380","0","1999","330000"
"3","4.5","5230","17826","3740","1490","2005","3400000"
"4","3.5","4230","20377","4230","0","1997","2080000"
"3","2.75","2810","18731","2810","0","1974","1700000"
"4","2.5","4570","74487","4570","0","1948","1580000"
"3","2.5","2190","11394","1550","640","1956","1290000"
"4","3.75","3520","3944","2200","1320","1913","1220000"
"4","2.5","3160","13194","3160","0","1965","1190000"
"4","3.25","3440","7661","3440","0","2006","905000"
"5","3.5","3500","10155","2570","930","1996","905000"
"3","1","1480","6978","1480","0","1949","899000"
"4","2.5","3030","29163","3030","0","1998","835000"
"5","2.5","4470","35124","4470","0","1984","831500"
"4","2.5","2500","206474","2500","0","1997","806000"
"3","2.25","2380","11824","1450","930","1972","800000"
"4","3","3520","4895","1980","1540","1954","800000"
"4","3.5","3910","59863","2490","1420","1987","780000"
"4","2.5","2300","6158","2300","0","1999","775000"
"3","2","1820","5000","1720","100","1941","750000"
"4","2.25","2270","5102","1340","930","1954","735000"
"3","1.75","1610","8613","1610","0","1962","725000"
"4","2.5","3420","30410","3420","0","1988","725000"
"4","2.5","2650","30500","1680","970","1960","715000"
"2","1","970","4560","970","0","1907","690000"
"2","1.5","1300","1676","1300","0","1943","685000"
"4","2.5","2810","11120","2810","0","1982","675000"
"3","2.5","3310","5300","2440","870","2008","670000"
"5","3","3190","7081","1890","1300","2013","664950"
"3","3.25","1980","2850","1980","0","1987","660000"
"4","2.5","2400","7351","2400","0","1990","650000"
"3","2.5","1500","1375","1200","300","2014","649950"
"2","1.75","2260","280962","1890","370","2005","649000"
"4","3.5","2960","6000","2960","0","2014","633634"
"5","2","2130","4180","1270","860","1926","615000"
"6","2.75","2660","8400","1550","1110","1962","603500"
"3","2.5","2260","10153","2260","0","1987","600000"
"4","2.5","3220","7875","3220","0","1966","590000"
"3","2.5","1640","1269","1640","0","2009","579000"
"3","2.5","2060","5750","1330","730","1976","577000"
"4","2","1730","3884","1060","670","1924","569000"
"3","2.25","1300","907","1000","300","2006","562500"
"3","2.5","1960","12476","1960","0","1989","560000"
"4","2.5","2300","7989","2300","0","1990","560000"
"3","2.5","1900","3255","1900","0","1988","550000"
"3","1.75","1840","8086","1840","0","1964","550000"
"2","1","1080","3500","1080","0","1924","525000"
"5","3.25","2910","5027","2040","870","2013","515000"
"6","2.5","2890","8122","1630","1260","1977","502000"
"3","1","1150","5100","1150","0","1911","500000"
"3","2.25","1630","3817","1630","0","2005","497000"
"3","2","2950","12196","2310","640","1918","495000"
"4","2.5","1830","7345","1540","290","1973","494000"
"4","2.5","1540","1860","1540","0","2014","491234"
"3","2.25","1470","2500","1080","390","1984","490000"
"3","2.25","2110","11319","2110","0","1978","479000"
"3","1.75","1800","6000","900","900","1905","471001"
"3","2.5","2150","8221","2150","0","1992","470000"
"5","2.5","3390","9760","1750","1640","1978","460000"
"4","2.5","2000","6107","2000","0","2003","459950"
"3","2","1890","1599","1430","460","2012","458500"
"4","1.75","2120","50965","1060","1060","1956","453000"
"4","1.75","2160","4333","1260","900","1942","450000"
"3","2.25","1780","7280","1340","440","1972","449500"
"4","2.5","1850","5040","1230","620","1930","449000"
"2","1","2550","21675","1610","940","1958","446000"
"3","1.75","1600","10280","1050","550","1977","442500"
"4","2.5","2520","7253","2520","0","1990","442000"
"3","1.75","1560","7207","1250","310","1983","440000"
"2","1.5","950","4625","950","0","1949","430000"
"3","1.75","1300","12731","1300","0","1981","430000"
"2","1","880","6413","880","0","1950","425000"
"3","2.25","1580","39189","1180","400","1992","425000"
"3","2","1200","5029","880","320","1937","420000"
"4","2.5","2170","8518","1350","820","1955","415000"
"2","1","860","2599","860","0","1901","405000"
"3","2.25","1520","1245","1520","0","2004","405000"
"3","1","1830","8004","1200","630","1960","403500"
"2","0.75","1020","1350","1020","0","2009","402101"
"4","1.75","1700","20283","1340","360","1965","400000"
"3","1.75","1560","5223","810","750","1940","399950"
"3","1.75","2390","7149","1350","1040","1955","396500"
"3","1.75","1880","12821","1880","0","1959","389800"
"3","3.25","1630","1677","1630","0","2007","385000"
"4","2.75","2700","37011","2700","0","1984","385000"
"4","2.5","1870","7471","1870","0","1990","375000"
"4","2","1940","25600","1940","0","1962","365000"
"2","1.5","940","1768","940","0","2009","362500"
"3","2.5","2430","15264","2430","0","1997","362300"
"4","1.5","1720","6417","1720","0","1953","360000"
"7","3","2800","9569","1400","1400","1963","350000"
"3","1.75","1660","10150","1660","0","1957","350000"
"3","2","2420","38781","1210","1210","1949","349900"
"3","1","1270","8400","1270","0","1955","347000"
"3","1.75","1270","8100","880","390","1950","346000"
"3","2.5","2110","4118","2110","0","1989","345950"
"3","3.75","1950","8625","1360","590","1959","345100"
"3","1","1140","4200","1140","0","1904","345000"
"3","1.5","1420","1192","1140","280","2008","345000"
"3","1.75","1310","12750","1310","0","1993","337000"
"1","1","720","5100","720","0","1907","335000"
"4","1.5","1150","9360","1150","0","1970","334000"
"3","2.5","2242","4995","2242","0","2011","329900"
"3","1","1030","9834","1030","0","1969","326000"
"4","1.75","2110","7208","1170","940","1975","324000"
"4","2.25","2010","19000","2010","0","1975","322200"
"3","2.5","2280","7417","2280","0","1998","320000"
"4","1.5","1890","43560","1890","0","1974","320000"
"5","3","2300","8214","2300","0","2013","312891"
"3","2.5","2540","4775","2540","0","2006","310000"
"4","2.5","2620","4469","2620","0","2008","300000"
"4","2.5","1840","5550","1840","0","2004","300000"
"2","1","1060","7200","1060","0","1951","299995"
"3","1","880","9238","880","0","1946","291500"
"2","2","1610","17600","1610","0","1930","290900"
"3","1","1150","8145","990","160","1932","290000"
"3","2.75","1100","750","780","320","2008","286000"
"3","2.5","1660","6263","1660","0","2003","285000"
"2","1","1010","3000","1010","0","1925","280000"
"2","1","1180","6552","1180","0","1949","275000"
"3","1","1080","6000","1080","0","1952","275000"
"4","2.5","2540","8400","2540","0","1977","269950"
"3","1.75","1840","7412","1240","600","1976","269500"
"3","1","1620","9450","1620","0","1928","265000"
"3","1.75","1760","7482","1760","0","1966","264000"
"3","1.75","1390","18200","1390","0","1962","261350"
"4","2.5","2000","37045","2000","0","1989","260000"
"3","2","1310","6738","1310","0","1990","249900"
"2","1.75","1500","8645","1500","0","1963","249500"
"3","1","1000","19204","1000","0","1968","249000"
"3","1.75","1230","9600","1230","0","1984","239950"
"3","1","1170","11100","1170","0","1968","235000"
"6","3","2180","7956","2180","0","1980","235000"
"4","1.75","1450","8891","1180","270","1962","235000"
"2","1","870","11100","870","0","1940","234000"
"3","2.25","1650","2958","1650","0","1985","233500"
"3","1","1530","389126","1530","0","1919","230000"
"3","1.75","1580","8820","1580","0","1967","225000"
"3","2","1340","8505","1340","0","1931","215000"
"2","1","880","6780","880","0","1945","205425"
"3","1.5","1090","9600","1090","0","1968","200000"
"5","2.5","1740","8750","1740","0","1959","199950"
"3","1","1200","13100","1200","0","1943","165000"
"3","1.5","1270","2356","1270","0","2012","160797"
"4","5","4550","18641","2600","1950","2002","3080000"
"5","2.75","3831","13800","3831","0","1959","2700000"
"5","4.75","6390","13180","4560","1830","1940","2470000"
"4","2.5","3220","15600","1680","1540","1973","1250000"
"4","3.75","3820","53574","3820","0","1994","1220000"
"3","2.5","2740","5925","2740","0","1913","1160000"
"2","2","1460","9052","1460","0","1900","1010000"
"4","2.25","2420","10200","2420","0","1973","998000"
"3","2.25","3060","9950","1810","1250","1930","970000"
"4","1.75","2320","3825","1820","500","1926","941000"
"4","3","3580","35261","3580","0","1985","925000"
"4","2.5","3030","3841","3030","0","2005","880000"
"4","2.5","3220","22588","3220","0","1996","875000"
"4","2.25","3550","13900","1830","1720","2010","859000"
"4","3.5","3920","37122","3920","0","1996","850000"
"4","3","3330","4000","1790","1540","1958","850000"
"3","2","2540","4750","1840","700","1930","845000"
"3","2.5","3200","203425","3200","0","2000","839000"
"3","3.5","2130","6150","1530","600","1908","819000"
"4","3.5","3190","31450","3190","0","2010","790000"
"4","2.75","2610","8760","1760","850","1978","762500"
"4","3.25","3090","9571","2370","720","2004","751000"
"4","2.5","2440","4850","2440","0","2013","745641"
"4","2.5","2650","18295","2650","0","1986","725000"
"3","1.75","2200","9840","1500","700","1978","689000"
"4","1.75","2330","5000","1510","820","1929","687500"
"3","1.5","1820","5756","1640","180","1946","683500"
"3","3.5","2300","5611","2300","0","2004","675000"
"6","2.75","2840","8346","1420","1420","1961","665000"
"2","2.25","2550","6000","1860","690","1902","660000"
"4","2.5","2341","9594","2341","0","1997","640000"
"4","2.5","2050","2772","2050","0","2012","639888"
"2","1","1130","2640","1130","0","1927","631500"
"3","2.5","2410","64073","1820","590","1976","625000"
"4","2.5","2450","55387","2450","0","1994","620000"
"2","1","1270","5000","1090","180","1949","615000"
"3","1.75","1720","4080","960","760","1924","615000"
"4","1.75","1740","7700","1740","0","1968","600000"
"4","3.25","4690","14930","3680","1010","1995","600000"
"5","2.75","2730","22572","2080","650","1968","599000"
"4","2.5","3190","8195","3190","0","2006","589950"
"3","2.5","2270","100545","2270","0","1998","585000"
"4","2.5","4620","20793","4620","0","1991","575000"
"3","2.25","2400","5000","1440","960","1926","575000"
"2","1","2034","13392","1159","875","1947","549000"
"3","2.5","2070","4132","2070","0","1999","535000"
"2","1.5","1580","3680","1280","300","1941","530000"
"3","1.75","2300","35722","2300","0","1984","520000"
"4","2.75","2520","14021","2520","0","1999","518000"
"3","2.25","1420","1309","1420","0","2006","510000"
"3","2","1300","14350","1300","0","1955","502000"
"3","2.5","1500","5412","900","600","1920","485000"
"2","1.75","1240","3000","1240","0","1906","483000"
"3","1.75","1150","10466","1150","0","1959","464500"
"3","2.25","1430","2003","980","450","1996","457500"
"4","2.5","2950","4502","2950","0","2005","455000"
"2","1.5","1200","1259","1000","200","2015","455000"
"4","1.75","1250","7400","1250","0","1959","445000"
"3","1.75","2000","9900","1480","520","1957","440000"
"3","1.75","1520","6380","790","730","1948","438000"
"4","2.5","1890","8505","1290","600","1980","437000"
"3","2.5","1930","4500","1930","0","1990","425000"
"4","1.5","1600","6180","1600","0","1946","425000"
"3","2.5","2140","3821","2140","0","2005","420000"
"3","1.75","1070","8000","1070","0","1977","415000"
"3","2.5","2280","6031","2280","0","2011","415000"
"3","2.5","3170","12750","2360","810","1995","405000"
"3","2.75","1310","7300","1310","0","1957","405000"
"3","1","1410","8053","1410","0","1951","405000"
"3","2","1230","11413","990","240","1984","400000"
"3","2.5","2970","23100","1510","1460","1967","400000"
"3","2.5","2590","18980","2590","0","1976","396500"
"4","1.75","1540","5120","770","770","1943","395000"
"3","2.5","1600","1936","1600","0","2007","395000"
"3","2.25","1860","15559","1860","0","1963","380000"
"3","2.5","1740","30886","1740","0","1992","379000"
"3","1","1660","11783","1160","500","1978","367500"
"3","1.75","1840","11440","1340","500","1977","366000"
"4","1.75","1450","8450","1450","0","1960","362500"
"3","1.75","1500","7200","1500","0","1957","360000"
"3","1.5","1810","100188","1810","0","1969","358000"
"2","2.25","930","747","630","300","2007","355000"
"2","1","740","7680","740","0","1922","350000"
"4","3","2560","5606","2560","0","2004","350000"
"4","2.5","2090","5289","2090","0","1989","349950"
"3","1.5","1360","10726","1360","0","1966","348500"
"4","1.75","1760","6204","1180","580","1950","343500"
"2","1.75","1210","7507","1210","0","1982","342500"
"4","2","2470","5080","1970","500","1948","339000"
"3","1","1100","4128","720","380","1942","339000"
"3","1","1480","7284","970","510","1963","336500"
"2","1","900","5220","900","0","1956","329950"
"2","1.5","830","1119","830","0","2005","329445"
"3","1","850","6906","850","0","1948","325000"
"3","1.5","1460","8710","1460","0","1955","324950"
"4","2.5","2510","7992","1610","900","1978","319000"
"5","2.5","2360","11375","1180","1180","1962","317000"
"4","1.75","2700","27072","1380","1320","1958","314900"
"4","2.25","2210","9371","2210","0","1968","305000"
"4","2","1310","8454","1310","0","1953","304000"
"3","1","2150","7007","2150","0","1954","300000"
"2","1","750","5120","750","0","1941","300000"
"2","1","650","5400","650","0","1950","295000"
"3","1.75","2000","7560","1300","700","1968","295000"
"3","2.5","1970","9607","1090","880","1988","289000"
"3","1","990","9253","990","0","1968","275000"
"3","1","1490","7435","1120","370","1969","258000"
"2","2","1180","9265","1180","0","1940","257500"
"3","2.25","1670","7881","1190","480","1977","252000"
"4","2.75","2000","5827","2000","0","1997","236000"
"4","1.75","1850","6000","1270","580","1944","230000"
"3","1.75","1330","13102","1330","0","1968","225000"
"3","1","880","18205","880","0","1945","218000"
"3","1.5","1330","7600","1330","0","1968","218000"
"2","1","970","5500","970","0","1956","210000"
"3","1","1000","8512","1000","0","1991","199000"
"3","1","1050","7577","1050","0","1983","194000"
"3","1.5","1010","9600","1010","0","1962","160000"
"2","1","690","5280","690","0","1942","139000"
"4","3.25","4250","8570","4250","0","2004","2300000"
"5","3.5","5850","22885","4670","1180","1978","1700000"
"3","1.5","2680","4775","1880","800","1913","1360000"
"3","1.5","1940","2885","1940","0","1900","1330000"
"4","3.5","4660","17398","4660","0","2003","1280000"
"4","3.5","3770","37034","2830","940","1989","1230000"
"4","1.75","3990","13470","3990","0","2006","1200000"
"3","2","2110","18815","2110","0","1979","1150000"
"4","2.25","3310","127631","3310","0","1924","1140000"
"5","3.25","3370","7947","3370","0","2001","1070000"
"4","4.5","4225","284011","4225","0","1985","1010000"
"3","4.5","4380","47044","3720","660","1968","995000"
"5","3","2620","5477","2620","0","2009","975000"
"5","3.25","3160","5000","2180","980","2005","957000"
"5","2.25","2370","15512","2370","0","1981","913888"
"5","3.5","3100","10200","1660","1440","1970","905000"
"4","1","2550","4000","2370","180","1905","890000"
"4","2.75","2840","4000","1960","880","1912","870000"
"5","3.25","4500","9648","3000","1500","1968","860000"
"4","2.5","3070","8086","3070","0","2005","804100"
"2","1","1740","5719","1740","0","1955","800000"
"4","2.5","3920","12415","3920","0","1997","770000"
"4","3.5","4000","15253","4000","0","2007","762000"
"4","2.5","2760","6000","2230","530","1942","760000"
"3","1.5","1840","5000","1340","500","1915","750000"
"5","2.5","2700","16570","1750","950","1967","744500"
"4","2.5","3000","10392","3000","0","1995","740000"
"5","2.5","2980","5377","2980","0","2006","739900"
"3","2.5","2610","7510","2610","0","1996","725000"
"4","2.5","2490","5170","2490","0","2000","725000"
"4","2.5","2770","5686","2770","0","2004","700000"
"5","2","2000","4211","1280","720","1908","690500"
"4","1.5","1880","6200","1440","440","1954","680000"
"3","2.75","2210","4000","2210","0","2008","660000"
"4","2.5","2180","3375","1420","760","1926","657000"
"4","2.75","1910","16532","1420","490","1940","650000"
"3","2.75","1850","16960","1850","0","1953","645000"
"33","1.75","1620","6000","1040","580","1947","640000"
"5","2.5","2700","21208","1950","750","1955","625000"
"4","2.5","2690","4736","2690","0","2001","608000"
"3","2.25","2680","9162","1570","1110","1978","599990"
"4","4","3570","8250","2860","710","2015","597326"
"3","1.75","1870","9000","1870","0","1958","595888"
"3","2.25","1270","1406","1060","210","2014","594000"
"4","2.75","2720","4613","2720","0","2005","594000"
"5","3","2790","19439","1500","1290","1973","589950"
"4","2.75","2890","6825","1560","1330","1973","585000"
"3","2.5","1790","8144","1790","0","1989","583000"
"4","2.5","2070","5415","2070","0","1996","578000"
"3","2.25","1700","3333","1100","600","1924","575000"
"3","2.5","2380","6832","2380","0","2002","574000"
"2","1.75","1670","4008","1670","0","2005","565000"
"3","2.5","1400","1312","1400","0","2007","563500"
"2","0.75","1440","3700","1200","240","1914","562100"
"3","1.75","1900","11165","1900","0","1959","557500"
"4","2.5","2030","3974","2030","0","1994","544000"
"4","2.75","3110","5133","3110","0","1958","531500"
"5","2.25","2140","7910","1070","1070","1962","530000"
"4","2.5","1950","2617","1250","700","1910","519000"
"3","2.5","1860","8060","1860","0","1987","505000"
"3","1.75","1640","10695","1640","0","1975","505000"
"3","1.5","1190","4750","970","220","1940","500000"
"3","2.5","2420","7307","2420","0","1998","482000"
"5","3.5","2640","6895","2640","0","2001","459000"
"3","1","1970","22144","1970","0","1970","454000"
"3","1.5","2330","11740","1330","1000","1954","450000"
"4","2.75","2310","5650","1330","980","1952","450000"
"2","1","1380","4390","880","500","1931","450000"
"3","1.75","2030","17100","2030","0","1953","440000"
"2","1","1060","3036","1060","0","1943","435000"
"3","2.5","2320","2267","2320","0","2009","425000"
"4","2.25","2100","9984","1290","810","1973","418800"
"3","1.5","1250","7700","1250","0","1968","410000"
"2","2.5","1590","1845","1590","0","1997","409900"
"4","2.25","2000","3672","1650","350","1926","402000"
"3","2.5","2180","7508","1420","760","1962","400000"
"2","2.25","1350","14258","1050","300","2007","395000"
"4","2.5","2340","8548","2340","0","1993","390000"
"4","2.25","2050","9583","1770","280","1965","386000"
"3","1.75","1500","13430","1500","0","1977","383000"
"2","1","900","2910","900","0","1924","381500"
"3","2.25","1400","11400","1400","0","1984","374500"
"3","2","1410","9600","1410","0","1983","365500"
"3","2.5","1800","2790","1800","0","2011","364000"
"4","2","2020","48693","2020","0","1949","356000"
"4","1","1530","8890","980","550","1925","352000"
"3","1","1010","8184","1010","0","1947","349000"
"2","1.75","1610","6300","1010","600","1941","346500"
"3","1","1150","11802","1150","0","1932","346500"
"6","2.25","3040","28535","1890","1150","1951","330000"
"3","2.5","1730","3600","1730","0","2014","328423"
"4","2.5","2000","10051","2000","0","1997","320000"
"4","2","1780","5336","930","850","1918","315000"
"2","1","870","5400","870","0","1950","310000"
"3","2.5","1860","3730","1860","0","2012","309620"
"3","1","1640","18144","1640","0","1942","308000"
"6","2","1900","8240","1200","700","1964","305000"
"3","2.5","1870","7942","1870","0","1990","299950"
"3","1.75","1790","7650","1790","0","1978","299950"
"3","1","1110","8593","1110","0","1979","299900"
"3","2.5","1150","887","1150","0","2007","288000"
"2","1","780","3475","780","0","1930","286000"
"3","2","1460","6377","1460","0","1995","285000"
"3","1","890","8400","890","0","1954","283000"
"3","1.75","1230","8250","1230","0","1966","280000"
"7","2.5","1940","5458","1940","0","1994","280000"
"3","1","1270","7566","1270","0","1958","276900"
"4","2.25","2460","11250","2460","0","1959","276000"
"2","1","770","4840","770","0","1927","275000"
"3","2.5","1670","8364","1300","370","1990","270000"
"2","1","2060","8398","1260","800","1962","270000"
"3","1.5","1150","8450","1150","0","1951","265950"
"2","1","1120","5650","1120","0","1944","260000"
"3","1.5","1580","8184","1140","440","1954","260000"
"5","2.5","2025","7760","2025","0","2007","260000"
"3","2.5","1720","3676","1720","0","1992","255950"
"4","2.25","1830","6136","1830","0","1990","249000"
"3","2.5","1620","7686","1620","0","1989","246500"
"3","2.25","1640","8400","1180","460","1968","245700"
"3","2","1410","5760","1410","0","1985","245000"
"3","2.25","1481","2820","1481","0","2012","240000"
"4","2","1570","9415","1570","0","1984","235000"
"3","1","1250","6180","1250","0","1955","233000"
"3","1","1050","8498","1050","0","1958","205000"
"3","1","1230","8750","1230","0","1965","205000"
"3","1","1150","4800","1150","0","1938","200000"
"3","2","1190","6833","1190","0","1995","200000"
"3","1","1320","9000","1320","0","1966","196500"
"1","0.75","930","29258","930","0","1941","190000"
"3","1","1090","3264","1090","0","1969","152000"
"2","1","890","8100","890","0","1942","150000"
"5","3","4480","5000","3420","1060","1902","1990000"
"4","2.25","3250","16684","3250","0","1979","1410000"
"4","3","4040","20001","2020","2020","1972","1390000"
"3","3","2480","5500","1730","750","1950","1390000"
"4","3.5","3190","5040","2160","1030","2003","1340000"
"3","3","3760","8500","3060","700","1910","1250000"
"3","2.5","2490","4000","1670","820","1918","1150000"
"4","3.5","3990","5267","3990","0","2008","1080000"
"4","3.5","3450","7832","3450","0","2007","1050000"
"4","3.5","3320","19850","2040","1280","1977","1030000"
"4","3.75","3460","6738","3460","0","2013","971971"
"3","1.75","2450","2691","1750","700","1915","937000"
"4","3.5","4040","50479","4040","0","1987","910000"
"4","3.5","3370","5000","2470","900","2008","900000"
"4","2.75","4230","31747","4230","0","1985","879000"
"4","2.5","3230","12100","1870","1360","1977","827000"
"4","2.5","3060","7140","3060","0","2006","826000"
"3","2","2270","11989","2270","0","1968","815000"
"4","2.75","2620","4743","1310","1310","1949","815000"
"3","2.75","2600","5875","1600","1000","1929","805000"
"3","1.75","2080","75794","2080","0","1958","800000"
"4","2.5","2990","16809","2990","0","1990","800000"
"4","3.25","3060","3898","2300","760","2014","782900"
"3","2.75","2850","14800","1920","930","1976","775000"
"4","2.5","2660","10800","2660","0","1955","772650"
"3","2.5","1980","13964","1980","0","1959","760000"
"4","2.75","2880","4000","2100","780","1912","755000"
"4","2.75","1750","5080","1750","0","1903","750000"
"6","3","3110","5000","1810","1300","1921","725000"
"3","3.25","3740","136915","3100","640","1990","710000"
"3","2.75","2590","12063","2590","0","1993","695000"
"5","3.5","2720","7598","1860","860","1993","690000"
"4","2.5","2770","10274","2770","0","1989","675750"
"3","1.5","1490","4400","1490","0","1906","670000"
"4","2.5","2670","11877","2670","0","1996","669950"
"2","1.75","1950","10766","1160","790","1952","669000"
"3","1.75","3320","478288","2260","1060","1933","667000"
"3","2.5","2480","37843","2480","0","1974","663000"
"3","2","1480","3876","860","620","1928","663000"
"3","1","1210","9622","1210","0","1955","660000"
"3","2","1660","3729","970","690","1922","638000"
"3","1.75","2430","5000","1760","670","1945","626000"
"6","3.5","3600","6875","2740","860","2004","620000"
"3","2","2460","41343","2460","0","1988","620000"
"3","2.5","3240","8016","2910","330","2004","600000"
"4","1.75","1720","6975","1420","300","1975","580000"
"5","3","3690","49709","2690","1000","1960","575000"
"4","1.75","2110","265716","2110","0","1979","568000"
"4","1.75","2085","174240","1610","475","1964","563500"
"4","2.5","2480","16360","1510","970","1959","560000"
"5","3","3640","6930","3640","0","2004","555000"
"4","2.5","2150","27540","2150","0","1997","550000"
"3","3","2410","209088","2410","0","1942","537000"
"3","2","2330","26571","2330","0","1987","530000"
"4","2.75","3030","6625","3030","0","2011","525000"
"3","3.5","1590","1102","1590","0","2010","518500"
"3","1.75","1440","11787","1440","0","1983","495000"
"3","1.75","1520","11085","1520","0","1983","475580"
"2","1.75","1240","6417","1240","0","1924","471000"
"3","2.5","1730","8490","1210","520","1969","460000"
"4","2.5","2550","19017","1300","1250","1961","460000"
"5","2.75","2830","8925","2830","0","1967","451000"
"3","1.5","1530","23660","1530","0","1952","450000"
"2","1.75","840","3340","700","140","1912","450000"
"2","1.5","1370","1221","1080","290","2008","446000"
"4","1.5","1770","4670","1770","0","1947","440000"
"4","2.5","2160","7826","1390","770","1976","440000"
"3","1.5","2120","6290","1220","900","1949","440000"
"4","2.5","2250","7526","2250","0","1989","440000"
"4","2.75","2110","8751","1510","600","1962","435000"
"3","2.5","2370","5353","2370","0","2009","429900"
"4","2","2100","4857","2100","0","1965","424000"
"3","1.75","1444","249126","1444","0","2008","420000"
"3","1","1170","6700","1170","0","1957","415000"
"3","2.5","2490","4540","2490","0","2012","414000"
"4","2.5","2220","4652","2220","0","2001","405000"
"2","1","620","2475","620","0","1911","402000"
"4","3","3060","5000","3060","0","2001","399000"
"3","3.25","1370","913","1100","270","2006","390000"
"4","2.5","3200","22651","1610","1590","1970","385000"
"3","1.5","2380","14500","1850","530","1961","370000"
"5","2","2280","19000","2280","0","1924","365000"
"5","1.75","1940","6654","1940","0","1953","359000"
"3","1.5","2450","12497","2450","0","1967","358000"
"3","1.5","1400","8840","1400","0","1952","357250"
"4","2.75","2530","7350","1280","1250","1977","354950"
"4","2.5","2580","5476","2580","0","2005","354000"
"3","2.25","1780","16290","1780","0","1987","350000"
"2","1","950","7954","950","0","1941","339000"
"3","2.5","1769","7324","1769","0","2012","334888"
"4","3","1930","3031","1200","730","2006","330675"
"3","1","1750","7800","1150","600","1956","329950"
"2","1","950","5316","950","0","1948","320000"
"3","2","1550","34175","1550","0","1999","320000"
"4","2.5","1940","10200","1140","800","1977","315000"
"4","2.5","2430","5499","2430","0","2002","310000"
"4","1.75","1530","17664","1530","0","1968","302000"
"3","2.25","1780","10395","1780","0","1967","300000"
"2","1","930","7740","930","0","1924","290000"
"4","2.25","2260","7200","2260","0","1984","289659"
"2","1","1010","7200","1010","0","1975","285000"
"4","2.25","2070","7350","2070","0","1977","280927"
"3","1.75","1580","6620","1580","0","1988","279900"
"4","2.25","2600","9900","1600","1000","1965","270000"
"2","1","1780","81021","1780","0","1954","270000"
"3","2.5","1650","6684","1650","0","1991","268000"
"3","1.5","1090","8160","1090","0","1967","267000"
"3","2","1470","20000","1470","0","1968","254600"
"5","2","2080","16117","1740","340","1959","254000"
"3","1","1640","12384","1090","550","1954","253500"
"4","1","1230","7410","1230","0","1944","252750"
"3","2","1900","8002","1900","0","1991","252500"
"3","2.5","1630","7700","1120","510","1978","249900"
"3","1","1140","27760","1140","0","1981","243800"
"4","1","1200","2171","1200","0","1933","240000"
"4","2","1330","5926","1330","0","1942","235867"
"5","2.5","2500","9583","1300","1200","1979","235000"
"3","1","1060","9946","1060","0","1956","230000"
"2","1.75","1590","11276","1590","0","1972","225500"
"3","2","1700","11475","970","730","1945","225000"
"4","1.5","1600","9289","1600","0","1959","224000"
"3","1.75","1500","11968","1500","0","2014","224000"
"3","1.5","1660","15600","1660","0","1981","220000"
"3","1","1090","6710","1090","0","1912","219500"
"2","1.75","1390","4482","1390","0","1980","216500"
"2","1","720","8040","720","0","1943","210000"
"2","1","920","7569","920","0","1950","202000"
"3","1.75","1260","9346","1260","0","1963","200500"
"3","1.5","1220","6000","1220","0","1968","177500"
"3","1.75","1570","15330","1080","490","1956","164950"
"3","1","1310","9612","960","350","1962","150000"
"4","4.5","6640","53330","6640","0","1993","1820000"
"4","3","3900","9750","2520","1380","1972","1620000"
"5","2.75","3650","13297","2750","900","1969","1200000"
"4","4.25","4390","13833","3320","1070","2003","1050000"
"3","2.25","1670","4800","1670","0","1903","1020000"
"4","2.75","3610","8580","3610","0","2014","982000"
"5","2.5","3260","24300","2310","950","1950","755000"
"4","2.25","3190","11597","2300","890","1984","750000"
"3","3","2630","4896","2630","0","2006","738000"
"4","3","2370","3672","1650","720","1916","735000"
"3","2.25","1490","1212","1040","450","2011","735000"
"3","2.5","3580","54450","3580","0","1990","725000"
"3","1.5","1200","6240","1030","170","1952","718500"
"2","1.5","1640","4080","1540","100","1916","710000"
"3","2.5","2440","4153","2440","0","2003","710000"
"3","2.5","1660","1545","1400","260","2002","700000"
"4","2.75","3190","10970","3190","0","1994","687500"
"3","2.25","2400","5300","1250","1150","1939","672500"
"2","1","1110","3200","1110","0","1925","665000"
"3","2.5","2610","35000","2610","0","1988","665000"
"5","2.5","2500","7200","1490","1010","1977","661500"
"4","2.5","2540","38677","2540","0","1987","652500"
"4","2.5","2770","63118","2770","0","1997","641000"
"4","1.75","2420","37800","1880","540","1981","602000"
"3","3.25","2310","3075","1730","580","2005","589500"
"3","1.75","1960","6380","980","980","1939","561500"
"4","2.5","2710","6583","2710","0","2003","560000"
"4","3.5","4150","16197","4150","0","2006","550000"
"4","1.75","2860","48351","1710","1150","1978","530000"
"2","0.75","840","40642","840","0","1937","528000"
"5","1.75","1890","5000","1090","800","1906","523460"
"1","1.25","1100","638","1100","0","2014","516500"
"2","1.5","1200","1687","1200","0","2008","504200"
"2","1.5","1520","8040","1520","0","1951","500000"
"4","1","1440","7100","1440","0","1906","500000"
"3","2.5","2230","5348","2230","0","2000","490000"
"4","2.75","2790","5527","2790","0","2014","483453"
"2","1","1500","3420","1500","0","1902","480000"
"4","2.5","2990","8913","2990","0","1991","469900"
"4","2.5","3060","6000","3060","0","2012","465000"
"4","2.25","2020","8424","1380","640","1979","464900"
"4","2.5","2110","35091","1290","820","1985","460000"
"4","3","2530","10000","2530","0","2013","459000"
"4","2.75","2300","37533","1550","750","1979","453000"
"2","1","1320","8380","1320","0","1953","447000"
"2","1","1050","2570","850","200","1927","430000"
"3","2.5","2432","9391","2432","0","2005","427000"
"3","1","1520","213444","1520","0","1988","425000"
"4","2.25","2300","7700","1380","920","1959","417000"
"3","1.75","2410","8944","1860","550","1967","415000"
"3","2.5","1060","1536","1060","0","2000","415000"
"3","2.75","2600","64626","2600","0","2009","415000"
"3","2","1400","45738","1400","0","1981","410000"
"3","1","2710","19000","2710","0","1950","410000"
"3","2.5","2570","10431","2570","0","1989","399950"
"5","1","1170","6757","800","370","1944","397000"
"4","2.5","3000","9793","3000","0","2002","394000"
"4","2.5","1890","7867","1890","0","1996","355000"
"2","2.25","1330","10838","1330","0","1985","355000"
"3","1.75","2040","22693","2040","0","1980","355000"
"5","1.75","2330","14322","1180","1150","1968","350000"
"3","1.75","1780","10409","1280","500","1981","342000"
"4","1.75","2440","7350","1610","830","1978","330000"
"5","2.75","2400","8050","2400","0","1998","327000"
"4","2.5","2570","4865","2570","0","2005","320000"
"6","4","3120","4240","2090","1030","1993","315000"
"3","1.5","1590","8911","1590","0","1956","300000"
"1","1","700","2500","700","0","1907","295000"
"4","2","1350","942","1350","0","2008","288790"
"2","1","910","8155","910","0","1948","285000"
"1","1","690","1950","690","0","1928","280000"
"3","2.5","1630","7950","1320","310","1985","279000"
"2","1","720","11400","720","0","1951","275500"
"2","1","700","4800","700","0","1922","260000"
"3","1.75","1650","12349","1650","0","1957","259500"
"3","2.25","1715","6819","1715","0","1995","257500"
"3","2.5","1720","6194","1720","0","1998","255000"
"3","3","1670","4440","1670","0","2014","246950"
"3","1.75","1400","6300","1400","0","1998","235000"
"3","1.75","1950","8712","1950","0","1960","235000"
"1","1.5","1170","1456","1070","100","2007","235000"
"4","1","1390","18000","1390","0","1955","234000"
"3","1.75","1010","9600","1010","0","1969","230000"
"2","1.75","1110","1773","1110","0","2014","229800"
"3","1","910","8789","910","0","1966","221000"
"2","1.75","1220","15600","1220","0","1972","215500"
"2","1","940","5040","940","0","1926","212700"
"3","1","970","9583","970","0","1967","209950"
"2","1","1020","8100","1020","0","1940","195000"
"2","1","900","3400","900","0","1905","191000"
"2","1","810","8424","810","0","1959","170000"
"3","1","1060","7473","1060","0","1959","140000"
"3","4.25","2820","7200","2460","360","1930","1600000"
"4","4.25","3500","8750","2140","1360","1951","1080000"
"4","2.5","2190","11500","1430","760","1972","699900"
"2","1","1050","2542","880","170","1904","650000"
"4","2.5","3130","40918","3130","0","1994","598000"
"5","2.5","2670","16777","1620","1050","1920","585000"
"3","2.5","1700","9100","1160","540","1998","475000"
"3","1.5","1500","5000","1140","360","1927","470000"
"3","1","1200","9087","1200","0","1969","339900"
"3","1.75","1700","1716","1200","500","1978","314500"
"4","1","1370","8499","1370","0","1949","300000"
"3","1","1040","8128","1040","0","1983","234000"
"2","1.75","1910","3376","1910","0","1980","230000"
"3","2.25","2120","54014","2120","0","1964","835000"
"2","1","840","3400","840","0","1924","530000"
"4","2.75","2950","15540","2120","830","1974","402000"
"3","3.5","1360","1275","1240","120","2007","397000"
"3","2","1610","15005","1610","0","1986","345000"
"5","2.75","2130","6222","1300","830","1991","325000"
"3","1","1800","7650","1800","0","1957","265000"
"4","3.75","4350","7965","4350","0","2013","2070000"
"5","4.25","4830","8050","3710","1120","1914","1930000"
"5","3.5","5000","26540","3410","1590","2008","1730000"
"5","3.25","4390","11250","4390","0","2007","1510000"
"4","2.5","2680","12215","1590","1090","1956","1310000"
"3","1.75","2200","14630","2200","0","1948","1230000"
"4","2","2120","3360","2120","0","1905","1200000"
"3","3","3790","5001","2810","980","1989","1170000"
"4","2.75","3330","9143","3330","0","1995","1100000"
"4","1.75","2010","6300","1610","400","1937","972000"
"4","3.25","3530","8589","3530","0","2007","963000"
"4","2.5","3670","7680","3670","0","2007","950000"
"2","2.5","1780","2067","1780","0","1974","935000"
"5","2.75","2520","16100","1570","950","1960","896000"
"4","2.5","3560","5265","3560","0","2014","882566"
"4","2.75","3220","4392","2320","900","1931","880000"
"4","1.5","1800","3245","1800","0","1929","875000"
"3","2.5","2650","2387","1830","820","1920","850000"
"4","2.5","3500","7048","3500","0","2005","780000"
"5","3","2870","5700","1950","920","1964","765000"
"4","2.5","3300","165528","3300","0","1984","760000"
"4","2.25","2500","4046","1520","980","1940","669500"
"3","2.5","3350","4007","2550","800","2005","635000"
"3","2","1890","29185","1470","420","1949","570000"
"3","2.25","2070","15002","2070","0","1955","560000"
"3","2.25","1720","9600","1220","500","1967","550000"
"4","1.5","2750","128502","1500","1250","1958","550000"
"3","2.5","1460","1613","1180","280","2007","544000"
"3","1","1580","6300","1180","400","1925","535000"
"4","2.25","1980","15086","1980","0","1981","530000"
"3","2.5","2600","4506","2600","0","2003","515000"
"4","3","3720","15048","3720","0","1979","500000"
"4","1.75","2120","9786","1640","480","1967","492650"
"3","2.25","2090","10733","1440","650","1958","491950"
"3","2.25","1470","4322","1470","0","1985","491500"
"4","3","2330","3497","1920","410","2003","490000"
"4","3","2440","9664","1890","550","1981","480000"
"3","1.75","3600","8666","2400","1200","1948","461000"
"3","2.5","1220","1330","1010","210","2008","457000"
"4","2.5","2960","6031","2960","0","2005","449000"
"4","2.25","2070","39446","1470","600","1977","445800"
"2","1.5","1190","3400","990","200","1919","441000"
"3","2.5","3180","7904","1810","1370","2006","439000"
"4","2.5","2290","11173","2290","0","1988","436500"
"4","2","1880","3840","970","910","1904","435000"
"2","2","1090","934","1090","0","2008","427500"
"2","1.75","1510","4980","1510","0","2006","419000"
"1","1.5","1010","5750","1010","0","1911","410000"
"5","3.25","2820","6589","2320","500","1906","408000"
"2","1","870","5750","870","0","1947","406500"
"4","2.5","2570","7859","2570","0","1992","397500"
"3","1.75","1300","7030","1300","0","1968","385000"
"4","2.5","2700","6998","2700","0","2001","383962"
"3","1","1320","7341","1320","0","1982","370000"
"4","2.75","2140","10316","2140","0","1993","359500"
"3","2.25","1370","1524","1370","0","2005","355000"
"3","1","960","8855","960","0","1958","349810"
"2","1","970","5750","970","0","1932","345000"
"4","2.5","2280","5000","2280","0","2006","345000"
"4","2.5","2230","5970","2230","0","2002","337000"
"4","2.5","2340","11784","2340","0","1997","330000"
"3","2.25","2310","7200","2310","0","1990","327500"
"3","1","1010","8800","1010","0","1954","308000"
"2","1","960","8153","960","0","1947","300000"
"3","2.5","1760","8584","1760","0","1937","289950"
"4","2.25","1830","8734","1830","0","1991","285000"
"2","2","1860","10856","1260","600","1952","265000"
"4","2","1360","60548","960","400","1960","263400"
"3","1.75","1410","8100","1410","0","1985","263000"
"2","1","1320","9967","940","380","1919","255000"
"3","2","1440","5000","1440","0","1965","250000"
"3","1","950","9400","950","0","1954","248000"
"3","2.75","1300","14197","860","440","1996","245000"
"2","1.5","1068","1758","1068","0","1990","243000"
"2","1","900","28800","900","0","1928","235000"
"2","1","1200","24792","1200","0","1976","170000"
"2","1","930","7623","930","0","1942","100000"
"5","5.5","7050","42840","4320","2730","1978","3800000"
"3","2.25","3530","17450","1840","1690","1930","2370000"
"4","4.75","3970","9778","3390","580","1928","2300000"
"4","2.75","3770","10900","3070","700","1924","1700000"
"3","3.25","3140","5445","2240","900","1913","1640000"
"4","2.75","2970","12750","2130","840","1918","1570000"
"4","3.5","4270","5800","3170","1100","1937","1360000"
"6","2.75","2630","5432","2510","120","1900","1300000"
"4","3.5","3400","3850","2790","610","2008","1200000"
"4","2.5","3340","10422","3340","0","1996","1150000"
"5","3.25","3350","4000","2510","840","1997","1110000"
"3","2.75","3890","7216","3260","630","1967","1080000"
"4","2.5","4570","16015","4570","0","1990","1060000"
"4","3.5","3770","8501","3770","0","2008","1020000"
"3","1","1640","12855","1500","140","1920","1010000"
"4","1.75","2130","5080","2130","0","1914","955500"
"4","1.5","2550","5055","2550","0","1910","952500"
"5","5.5","5190","12637","5190","0","2001","925000"
"4","3.5","4080","10666","4080","0","2005","920000"
"5","3.5","3840","8279","3840","0","2001","875000"
"4","3.25","4350","112750","2200","2150","2006","850000"
"4","2.75","3990","6637","3990","0","2003","825000"
"3","2.25","2880","9750","2880","0","1989","820000"
"4","2.25","2500","8866","2500","0","1987","808000"
"3","3.5","3830","221284","3530","300","1993","800000"
"5","2.5","3290","5029","3290","0","2004","739900"
"2","2.25","2130","4920","1530","600","1941","730000"
"4","2.5","2840","12866","1780","1060","1977","729032"
"3","1.75","1860","6000","1860","0","1959","725000"
"3","2.5","2375","4094","2375","0","2002","712000"
"3","2.5","2620","51354","2620","0","1998","695000"
"3","2","2500","4080","1680","820","1922","695000"
"4","2.5","2600","7200","2600","0","1962","691500"
"3","2","2570","28500","1970","600","1983","660000"
"4","2.5","3350","46748","3350","0","2004","650000"
"2","2.25","1540","965","1540","0","2007","640000"
"3","2.5","2390","1984","2220","170","2008","629800"
"4","3","2130","6325","1440","690","1948","620000"
"4","1.75","1700","5846","1700","0","1957","616000"
"2","2.5","2510","14878","2510","0","1990","600000"
"5","2.25","2980","7781","1580","1400","1960","600000"
"2","1","910","2002","910","0","1900","600000"
"4","2.5","1820","20011","1820","0","1987","595000"
"3","2","1410","6413","910","500","1947","590000"
"4","1","1630","2566","1630","0","1921","581000"
"3","2.5","2200","11000","2200","0","1978","580000"
"4","2.5","2590","8483","2590","0","1991","570000"
"4","1","1410","3376","1410","0","1911","563000"
"4","2.5","2440","11005","2440","0","1994","548000"
"3","2.5","1530","3210","1010","520","1928","545000"
"3","1.75","2050","9580","1400","650","1984","540000"
"4","2.5","2180","10140","1180","1000","1968","540000"
"4","1.75","1420","5000","1420","0","1945","535000"
"3","2.5","3660","39478","3260","400","1989","530000"
"2","2.5","1160","1458","1040","120","2012","525000"
"3","2.5","2010","7200","2010","0","1994","515000"
"2","1","1050","5000","1050","0","1907","515000"
"3","1.75","1750","7020","1750","0","1934","510000"
"3","1.75","1990","9594","1190","800","1977","507500"
"4","2.75","2200","9778","1100","1100","1962","505000"
"3","2.25","1600","45613","1600","0","1983","502000"
"2","1","950","4500","850","100","1926","500000"
"5","3.25","3130","12087","2180","950","1975","500000"
"4","2.75","2910","6334","2910","0","2013","499990"
"3","2.25","2440","47916","2090","350","1991","485000"
"4","1.75","1430","4096","1430","0","1900","485000"
"3","2.25","1710","21485","1710","0","1989","482000"
"3","2.25","1640","3896","1640","0","1994","478000"
"4","3","2890","6885","1590","1300","1945","476000"
"3","2.5","1450","1053","940","510","2008","460000"
"2","1","1250","3825","850","400","1929","459500"
"3","1.75","1110","9012","1110","0","1966","452000"
"3","1.75","1400","13775","1400","0","1963","450000"
"4","2.5","2280","42077","2280","0","1994","445000"
"3","2.5","2530","13446","2530","0","1993","435000"
"4","1.5","1550","5053","1180","370","1963","433000"
"4","2.5","2300","6087","2300","0","2001","431000"
"3","1.5","1300","19163","1300","0","1964","425000"
"3","2.5","1950","5689","1950","0","2009","425000"
"4","2.5","2530","5048","2530","0","2014","417838"
"4","1","1580","8475","1580","0","1928","406000"
"2","1","800","2280","800","0","1946","402500"
"3","2","1240","11172","1000","240","1984","401000"
"4","2.5","2701","4500","2701","0","2014","399895"
"5","2.25","3740","32481","2240","1500","1958","392000"
"3","1.75","1040","9000","1040","0","1967","382500"
"3","1.75","2530","35150","1800","730","1977","375000"
"2","1","860","6050","860","0","1952","370000"
"3","3.5","2080","5100","2080","0","2004","357500"
"3","2","1270","3600","1270","0","1963","349500"
"2","1","1080","7775","1080","0","1955","345000"
"3","2.25","1460","941","1460","0","2006","337000"
"2","2.5","1050","1029","950","100","2007","332888"
"3","2.5","1680","11312","1080","600","1959","330000"
"4","1.75","2550","8976","1300","1250","1978","328950"
"4","2.5","1830","9601","1830","0","2003","321000"
"3","2","2050","13303","2050","0","1993","314500"
"3","1","1150","6000","1150","0","1927","307000"
"3","2.25","1660","5128","1660","0","2001","300000"
"3","2.75","2090","9620","1340","750","1987","300000"
"4","2.5","2303","3826","2303","0","2006","300000"
"3","1","1090","10710","1090","0","1962","280000"
"1","0.75","370","1801","370","0","1923","276000"
"4","2.5","1970","6600","1970","0","1987","274900"
"2","1","770","7906","770","0","1948","260000"
"3","2.25","1920","9680","1300","620","1961","260000"
"3","2","1190","4072","1190","0","1907","245000"
"3","2","1770","7000","1770","0","1986","241000"
"3","1.5","1620","9310","1620","0","1967","219950"
"3","1.75","1400","9546","1400","0","1984","217500"
"3","1.75","1170","8239","1170","0","1981","205000"
"1","1","590","833","590","0","1926","202000"
"2","1","900","13531","900","0","1979","174000"
"3","1","1200","8514","1200","0","1959","165050"
"2","1","820","4320","820","0","1937","102500"
"5","6.25","8020","21738","8020","0","2001","3300000"
"4","2.5","4080","18362","4080","0","1983","2290000"
"4","3.25","4040","18916","4040","0","1954","2270000"
"3","3.5","4660","5500","3040","1620","1909","2150000"
"2","2.5","3180","9400","2610","570","1985","1410000"
"4","1.75","2610","21600","2610","0","1966","1300000"
"3","2.5","3280","8400","1680","1600","1970","1080000"
"4","3.5","3390","3979","2610","780","2014","1050000"
"4","1.75","1440","13296","1440","0","1967","1040000"
"6","4.5","3830","4800","3050","780","1919","989000"
"3","4.5","3850","62726","3120","730","2013","915000"
"4","2.25","1950","5950","1330","620","1947","895000"
"4","1.75","1880","3720","1880","0","1924","860000"
"5","3.25","3760","9792","2550","1210","1984","851000"
"3","3","2470","7410","1860","610","1977","811000"
"4","2.5","2890","7798","2890","0","2005","795000"
"2","1.5","1570","175421","1320","250","1906","782000"
"2","1","1500","4000","1100","400","1933","736000"
"3","3.75","2670","6517","2020","650","1977","732000"
"4","2.25","2430","4748","1630","800","1928","723000"
"4","3","3550","12327","2180","1370","1990","720000"
"3","2.5","2490","23891","2490","0","1993","700000"
"3","1.5","1760","4000","1760","0","1922","690000"
"5","2.25","2900","10300","1450","1450","1985","675000"
"5","2.5","2950","5500","1720","1230","1918","660500"
"4","2","2090","10800","2090","0","1951","659000"
"3","1.75","2270","11472","1370","900","1956","645000"
"4","2.5","2190","9880","1410","780","1979","630000"
"3","3","1820","1641","1540","280","2006","625000"
"3","2.25","2080","12134","1530","550","1973","605000"
"4","2.25","2940","48788","1520","1420","1961","605000"
"5","2","2190","9072","1110","1080","1965","600000"
"4","3.5","2500","3080","1810","690","2008","599950"
"3","2.25","1900","3960","1200","700","1905","580000"
"3","1.75","2680","8625","1590","1090","1974","575000"
"4","2","1660","4800","1660","0","1922","575000"
"3","2.5","2280","2502","1880","400","2006","567500"
"3","2.5","1840","9900","1840","0","1978","552000"
"4","2.75","2160","5005","1430","730","1987","550000"
"3","2","1340","7200","1340","0","1923","545000"
"3","2.25","1320","1800","1320","0","1994","540000"
"3","1.75","2330","12141","1390","940","1983","535000"
"2","1.75","1530","3503","830","700","1916","525000"
"3","1.75","1490","1210","1090","400","2008","520000"
"5","2.25","2570","13054","1470","1100","1950","519000"
"3","1.75","1540","3000","770","770","1920","512031"
"2","1","900","9260","900","0","1946","496000"
"3","3","3700","10375","3700","0","1982","489000"
"4","2.5","1540","1870","1540","0","2014","484998"
"3","2.25","1550","5511","1550","0","1987","481015"
"3","2","1470","10052","1470","0","1956","480000"
"5","2.5","2160","7737","2160","0","1998","480000"
"4","2.5","2040","7260","2040","0","1963","475000"
"4","2.5","1850","5444","1850","0","1981","475000"
"4","2","2100","13468","1050","1050","1962","475000"
"4","2.75","2620","6178","2620","0","2013","475000"
"3","2","1660","15050","1260","400","1983","453000"
"3","2.5","1900","7984","1900","0","1993","435000"
"3","1","1520","9030","1520","0","1956","415000"
"4","2","2370","76665","2370","0","1978","411000"
"4","2.5","3002","6042","3002","0","2004","394500"
"4","1.75","2400","7700","1500","900","1927","389000"
"3","1.75","1730","7416","1730","0","1954","355000"
"5","2.5","2450","6994","2450","0","2002","345000"
"4","2.5","1954","4805","1954","0","2005","340000"
"3","2.5","2390","34041","1840","550","1984","339950"
"2","1.5","830","1858","830","0","2005","334500"
"4","2.5","2105","6093","2105","0","2003","330000"
"4","2.5","2120","4558","2120","0","2002","329950"
"2","1","700","3000","700","0","1918","310000"
"3","2.5","2242","4500","2242","0","2014","309780"
"2","1","2160","12960","1360","800","1968","305000"
"3","1","1580","7424","1010","570","1962","305000"
"2","1","1010","169448","1010","0","1947","300000"
"3","2.25","1520","7199","1520","0","1992","275250"
"3","2.25","1450","4050","1450","0","2010","274500"
"2","1.5","800","2119","800","0","2008","265050"
"4","3","1940","8170","1940","0","1948","265000"
"5","1","1870","7800","1580","290","1962","262000"
"4","2","1620","7992","1620","0","1975","260000"
"4","2.5","2050","5787","2050","0","2002","256000"
"4","2","2430","8960","1430","1000","1960","255000"
"4","2.25","1680","3179","1680","0","2002","255000"
"2","1","1310","7128","940","370","1980","253000"
"3","2.25","1920","7738","1520","400","1965","250000"
"3","1.75","1200","24805","1200","0","1984","250000"
"3","2","1110","7231","1110","0","1991","223000"
"5","1","1590","6700","1090","500","1942","185000"
"4","2.5","1780","5000","1780","0","1991","175000"
"2","1","1050","6600","1050","0","1964","123000"
"4","4.25","5010","19412","4000","1010","2014","2350000"
"4","3.25","3930","10929","3930","0","2006","1880000"
"3","2","2360","4800","2360","0","1909","1760000"
"4","3.25","2980","3600","2150","830","1999","1630000"
"5","3","3420","18129","2540","880","1952","1200000"
"5","2.5","3580","8921","3580","0","2000","1150000"
"3","2.5","2780","33503","2110","670","1969","1140000"
"4","2.5","3160","8281","3160","0","1995","1130000"
"4","3.75","5070","60123","5070","0","2000","1100000"
"4","5","4110","43560","4110","0","1978","1040000"
"4","3.5","4370","10860","4370","0","2008","1030000"
"3","3.25","3620","4000","2730","890","2005","1020000"
"4","2.5","2980","16263","2980","0","1989","1010000"
"6","2.75","2520","54160","2520","0","1954","975000"
"4","2","2490","9525","2490","0","1968","940000"
"3","2.5","3230","5000","2430","800","1945","850000"
"3","2","2470","8800","2470","0","1961","850000"
"4","4.25","4930","25714","4930","0","2005","835000"
"4","2.5","3150","4203","3150","0","2002","815000"
"3","1.5","1520","9041","1520","0","1954","810000"
"3","4","2080","2250","2080","0","1997","715000"
"3","1.5","1380","4500","1380","0","1960","650000"
"3","2.25","1980","10115","1980","0","1959","640000"
"4","2.5","2360","10000","1980","380","1977","633000"
"3","2","2300","13418","1430","870","1955","610000"
"3","1.75","1630","1526","1630","0","2014","609000"
"4","2.5","2800","10786","1420","1380","1970","605000"
"3","2.5","2610","6405","2610","0","2001","605000"
"5","2.25","3000","13899","3000","0","1975","600000"
"5","3","2190","4900","1490","700","1940","588000"
"3","1.75","1530","6743","1410","120","1955","575000"
"4","2.5","2230","8624","1430","800","1969","565000"
"3","2.5","2950","10254","2950","0","2006","554950"
"4","2.5","2020","4350","1730","290","1943","554729"
"3","1","1240","5000","1240","0","1909","529950"
"4","3","2590","6160","2590","0","2014","519995"
"5","3.25","2740","9629","1390","1350","1977","515000"
"2","1.5","1930","3521","1930","0","1989","509000"
"3","2.5","3316","11447","3316","0","1986","490600"
"3","1.75","1530","8000","1530","0","1978","474000"
"3","2.5","2250","5692","2250","0","2000","445838"
"3","2.5","1930","1348","1300","630","2005","439990"
"3","1.5","1810","5080","1030","780","1958","430000"
"3","1.5","1400","1022","1400","0","2007","425000"
"4","2.5","1700","9000","1700","0","1972","410000"
"2","2.75","1350","1252","1120","230","2006","405500"
"4","2.25","2230","7200","1300","930","1963","400000"
"2","1.75","1410","1005","900","510","2011","399900"
"5","1.75","1840","10453","1360","480","1948","395000"
"4","2.75","2640","35070","2640","0","1963","395000"
"4","2","1900","76877","1900","0","2004","390000"
"2","1","860","5040","860","0","1956","370000"
"2","1","870","4600","870","0","1942","357000"
"4","2.5","2040","5523","2040","0","1999","345000"
"4","2.5","2300","6448","2300","0","2001","342000"
"3","1","1390","4814","1390","0","1908","341000"
"8","2.75","2790","6695","1470","1320","1977","340000"
"3","1.75","1830","7969","930","900","1950","312500"
"4","1.75","2600","11325","1610","990","1969","304900"
"2","1","1190","6200","1190","0","1948","295950"
"3","1","1440","11250","1440","0","1967","290000"
"3","2.5","1520","3593","1520","0","2004","288000"
"5","2.5","2270","6300","2270","0","1995","285000"
"4","2.5","1890","6962","1890","0","1997","280500"
"3","1","1740","10875","1020","720","1962","267000"
"3","2","1180","7793","1180","0","1992","265900"
"3","1","1020","8610","1020","0","1959","265000"
"4","2.25","2060","11385","1200","860","1962","264500"
"2","1.5","920","1598","920","0","1995","255000"
"3","1.75","1770","8868","1770","0","1959","250000"
"3","1.75","1570","8750","1570","0","1960","240000"
"4","1","1200","6000","1200","0","1923","220000"
"4","1.75","2080","7200","1050","1030","1966","198000"
"2","0.75","660","5240","660","0","1912","100000"
"3","1.5","1300","7200","1300","0","1960","625000"
"3","2.5","2320","7609","2320","0","2003","600000"
"4","2.25","2920","5000","2260","660","1937","1740000"
"4","2.5","2700","4275","2700","0","2004","1200000"
"4","2.25","2110","12653","2110","0","1972","825000"
"4","3","3130","5700","1750","1380","1953","671000"
"3","2.5","1540","1326","1390","150","1995","499000"
"3","1.75","1470","4950","1030","440","1984","459500"
"4","2.5","3160","4620","2020","1140","1917","1280000"
"2","1.75","1990","4000","1090","900","1952","625000"
"3","1.75","1480","7700","1480","0","1975","395000"
"3","2.5","3110","6765","2550","560","1946","1640000"
"4","3.25","3770","4103","2710","1060","1925","1450000"
"4","3","5430","108900","5430","0","1987","1360000"
"4","2.25","2360","4000","2360","0","2013","1300000"
"3","2.5","3870","46609","3870","0","1997","1280000"
"3","2.5","3540","38322","3540","0","1989","888550"
"3","1.5","1820","12686","1820","0","1952","875000"
"4","3","3040","36246","2680","360","1923","870000"
"4","3.25","3990","9786","3990","0","2004","866000"
"5","2.75","3595","5639","3595","0","2014","861990"
"3","2.75","2760","8476","1690","1070","1967","821000"
"4","2","2600","4800","1400","1200","1953","780000"
"4","3.25","4100","241322","2500","1600","1981","775000"
"4","2.25","2350","18600","2350","0","1977","747500"
"3","3.25","2030","11070","2030","0","1980","685000"
"3","1.75","1880","10032","1880","0","1984","681000"
"4","2.75","2330","3920","2330","0","2005","680000"
"6","3","4050","36171","2620","1430","1970","670000"
"5","2.5","2860","68519","2860","0","1958","670000"
"5","2","2800","17788","1400","1400","1963","665000"
"4","2.5","2690","18653","2690","0","1985","645000"
"4","2","2530","5650","1910","620","1910","631500"
"3","2.75","1830","1850","1690","140","2011","593000"
"3","2","1860","4777","1860","0","1908","588000"
"4","2.5","2400","6137","2400","0","1990","575000"
"3","1","1890","3330","1390","500","1901","570000"
"3","2","1640","2808","820","820","1924","570000"
"2","2","1580","5750","790","790","1910","558000"
"3","1.5","1740","4200","1640","100","1920","555000"
"4","1","1660","4704","1260","400","1930","548800"
"3","2.5","2040","10086","2040","0","1987","542500"
"3","2.25","2590","15229","2590","0","1984","538250"
"2","1.5","1130","746","1030","100","2009","536000"
"3","1.75","1320","2500","870","450","1918","530000"
"6","3.5","3000","8401","1500","1500","1979","527000"
"3","2.5","1420","1237","1420","0","2014","510000"
"3","2.5","3030","9053","3030","0","2009","509900"
"2","2.25","1060","1209","940","120","2006","505000"
"4","2","1700","8640","850","850","1955","500000"
"3","2.5","1720","3012","1720","0","2011","500000"
"3","2.5","1910","2091","1910","0","2014","494815"
"2","1","1290","4650","1290","0","1906","494000"
"4","2.5","2286","6250","2286","0","2002","481000"
"3","2.25","1680","9090","1130","550","1959","480000"
"5","2.5","2510","8050","1490","1020","1977","475000"
"3","2.5","1990","12793","1990","0","1993","450000"
"3","1.75","1480","8394","1480","0","1971","450000"
"2","2","1240","2500","1240","0","1985","445000"
"5","1.75","1650","3000","1650","0","1902","443000"
"3","2","1490","4800","1490","0","1948","437500"
"3","1.75","2220","17568","2220","0","1967","437000"
"3","2.25","1620","1075","1540","80","2009","420000"
"3","2.25","1450","19206","1450","0","1989","410000"
"4","2.25","2340","217014","2340","0","1982","404950"
"3","2.5","1920","9625","1920","0","1993","391500"
"2","1","1190","4440","1190","0","1981","382500"
"3","2.5","1601","2491","1536","65","2007","378000"
"2","1.5","1260","1575","1260","0","2001","374000"
"4","1.75","1590","7920","1590","0","1960","373000"
"3","1.5","1800","22000","1800","0","1931","360000"
"3","2.5","2370","4200","2370","0","2014","351999"
"3","2.5","1450","3748","1450","0","2004","339000"
"2","1.5","800","5192","800","0","1951","335950"
"3","2","2250","7904","2250","0","1998","328000"
"3","1","1560","7552","910","650","1948","320000"
"3","1.75","2220","11646","1270","950","1950","320000"
"3","1","1120","10576","1120","0","1969","320000"
"4","3","2200","10800","2200","0","1960","300000"
"3","1","930","5160","930","0","1919","300000"
"4","2.5","2090","5195","2090","0","2007","300000"
"3","2.5","1520","4170","1520","0","2004","296475"
"3","1.75","1940","7500","1940","0","1918","295000"
"3","1.5","1640","7222","1640","0","1908","295000"
"4","2.25","1995","7102","1995","0","1981","266000"
"2","1","1500","6685","1190","310","1926","245000"
"3","1","1390","6000","1390","0","1954","230000"
"3","1.75","1140","1201","1140","0","2014","230000"
"3","1","1230","6000","1230","0","1967","229500"
"3","1","960","9563","960","0","1967","215000"
"3","1.5","1180","7300","1180","0","1968","209950"
"3","1","1100","5000","1100","0","1961","199990"
"2","1","1190","27007","1190","0","1910","195000"
"2","1","1060","7700","820","240","1981","170500"
"4","5.25","6500","14986","5180","1320","2001","2460000"
"6","2.75","4710","11000","3690","1020","1931","2180000"
"3","2.5","3490","8343","2150","1340","1939","1680000"
"4","2.25","2890","18226","2890","0","1984","1570000"
"4","3.5","3150","5500","3150","0","2014","1210000"
"4","3.5","3960","6654","2850","1110","2006","1200000"
"3","2.5","3830","48743","3830","0","1991","1150000"
"5","4","7320","217800","7320","0","1992","1140000"
"3","2.25","2790","13791","2790","0","2006","1130000"
"4","2.5","3180","31931","2390","790","1978","1120000"
"2","2","2360","11340","2360","0","1997","1090000"
"4","3.75","4740","126759","4740","0","1991","1050000"
"4","2.75","2250","3433","1500","750","1927","1050000"
"4","2.5","3130","10849","3130","0","2013","999000"
"5","2.75","3500","5040","2950","550","1927","970000"
"3","2.5","3480","7800","1750","1730","1941","950000"
"3","2.5","3180","12600","3180","0","1978","900000"
"4","2.75","2310","4020","2310","0","1979","890000"
"4","3.5","3110","108464","3110","0","1979","875000"
"3","2.75","3176","13391","2726","450","1985","819000"
"4","3.5","3370","3634","2750","620","2007","812000"
"2","2.75","2700","8572","2700","0","2007","810000"
"3","2.5","3420","25150","1750","1670","1987","789900"
"4","3.5","5270","53428","3440","1830","2004","782000"
"2","2.5","2560","2500","1690","870","1901","780000"
"4","4","3010","7221","3010","0","2004","765000"
"4","2.75","3090","5859","3090","0","2010","760005"
"4","2.25","2410","8400","2410","0","1965","720000"
"4","3","3580","9316","2370","1210","1991","711600"
"5","2.75","2510","9180","1600","910","1975","695500"
"4","2.5","3220","35400","3220","0","1991","690000"
"4","2.5","2610","5140","2610","0","2006","674600"
"3","2.75","2830","3496","2830","0","2012","673000"
"4","3","3720","57499","1880","1840","2003","650000"
"4","2.5","2850","37522","2850","0","1987","645000"
"2","2.5","2290","3507","2290","0","2005","630000"
"3","1.75","2050","16313","2050","0","1973","623000"
"2","2","1170","1890","1170","0","1927","613000"
"3","2.25","1900","46609","1440","460","1969","600000"
"4","2.5","2250","11370","2250","0","1991","600000"
"3","2","2560","14680","1330","1230","1987","599000"
"2","2","1570","4665","1570","0","2006","592350"
"4","2.5","2630","6185","2630","0","1999","585000"
"4","2.5","2130","35752","1490","640","1980","580000"
"3","2.25","1940","5980","1520","420","1987","580000"
"4","1.75","2790","17476","1450","1340","1956","568000"
"4","2.25","1950","9800","1330","620","1968","560000"
"3","2.25","1820","9670","1820","0","1984","557500"
"3","3.5","2490","3582","1720","770","2005","550000"
"3","1.75","1070","8030","1070","0","1966","542000"
"2","2.5","1785","779","1595","190","1975","530000"
"5","2.5","2820","9375","1550","1270","1968","527700"
"2","1.5","1920","3408","960","960","1912","517000"
"3","2.5","1810","4592","1810","0","1992","513000"
"4","2.25","1900","7200","1370","530","1977","485000"
"2","1","1060","3040","860","200","1924","480000"
"3","1","1340","13750","1340","0","1955","479000"
"4","2.75","2530","14178","2530","0","1997","469950"
"3","1.5","1830","9848","1830","0","1962","468000"
"4","2.5","2620","8331","2620","0","1991","460000"
"4","2.5","1910","10300","1910","0","1921","458400"
"4","3.5","3440","6000","3440","0","2002","455000"
"4","2.5","2680","5539","2680","0","2013","449990"
"3","2","1860","217800","1860","0","1998","440000"
"4","2.25","2570","9503","2570","0","1980","439000"
"2","2","1270","1372","1270","0","2000","438000"
"4","2.75","2230","9640","1320","910","1998","435000"
"4","2.5","2150","3143","2150","0","2010","435000"
"3","2","1550","6039","830","720","1942","430000"
"2","1","880","4000","880","0","1940","427550"
"4","1.75","1920","7700","1920","0","1970","415000"
"3","1.75","1880","5752","940","940","1945","412000"
"4","2.25","2060","7283","1220","840","1963","410000"
"4","2.5","2560","4020","2560","0","2006","410000"
"3","2","1320","6000","1320","0","1920","410000"
"3","1.5","1010","7683","1010","0","1953","405000"
"4","1.75","1360","4840","1360","0","1928","399500"
"3","1.75","1180","16552","1180","0","1967","390000"
"3","2.25","2090","15000","2090","0","1961","383000"
"4","2.5","1984","32400","1564","420","1962","380000"
"3","2.5","2860","43821","2860","0","1990","378500"
"3","1.75","1660","9673","1130","530","1976","375000"
"3","1","1650","6400","980","670","1954","371500"
"3","1.75","1570","16817","1570","0","1982","370000"
"4","1.75","2100","11942","1030","1070","1964","368000"
"5","3","1810","3000","1810","0","1998","362000"
"2","1.75","1210","1032","1210","0","2014","357562"
"4","2.75","3000","5470","3000","0","2005","355000"
"3","2.25","2120","13090","2120","0","1997","340000"
"3","2.25","2760","10160","2760","0","1969","336000"
"4","2.5","2530","8169","2530","0","1993","336000"
"3","2.5","2538","4600","2538","0","2013","335606"
"4","2.5","2250","3916","2250","0","2014","333490"
"3","2.25","2120","14915","1720","400","1979","332000"
"3","2.25","2220","4060","1330","890","1993","330000"
"3","1","1060","7920","1060","0","1968","326500"
"2","1","800","7260","800","0","1953","325000"
"2","1","810","4080","810","0","1941","325000"
"3","3.25","1450","1387","1180","270","2013","320000"
"2","1","1080","2674","720","360","1919","315000"
"4","2.5","1920","8562","1920","0","1994","308950"
"4","2.5","2200","8065","2200","0","1998","300000"
"3","1","1150","7314","1150","0","1960","300000"
"3","2.25","1910","3481","1910","0","2009","293000"
"3","1.5","1520","7123","1520","0","1959","292600"
"2","1","770","8149","770","0","1948","277000"
"3","1","1400","8100","1400","0","1944","267000"
"3","1.75","1550","9720","1050","500","1976","255000"
"3","1.75","1140","10400","1140","0","1983","250000"
"2","1.5","1090","2686","1090","0","1982","249000"
"4","2.25","2600","6390","1390","1210","1978","245000"
"3","2.5","1600","2788","1600","0","1992","245000"
"5","2.5","2340","5000","1670","670","1967","235500"
"2","1","1020","7920","1020","0","1939","235000"
"3","1.5","1460","15000","1460","0","1966","232000"
"3","1.75","1200","9085","1200","0","1968","228950"
"3","2","960","9380","960","0","1949","210000"
"3","1","1070","8179","1070","0","1949","210000"
"3","1","1180","8240","1180","0","1967","205000"
"3","1","1320","5000","1320","0","1912","201500"
"3","1","910","10575","910","0","1968","190000"
"3","1","1040","8892","800","240","1958","183500"
"1","1","850","8050","850","0","1906","165000"
"3","1","1350","8700","1350","0","1942","160000"
"3","1","1400","7360","1400","0","1968","148226"
"2","1","630","4200","630","0","1930","148000"
"1","2","1150","9812","1150","0","1962","115000"
"5","3","4290","20445","4290","0","1985","2680000"
"5","4.75","5780","17004","4260","1520","2006","2320000"
"5","5.25","4830","18707","3930","900","1952","1680000"
"6","4.5","4230","6420","2360","1870","1916","1470000"
"4","3.5","3550","11000","2260","1290","1999","1360000"
"4","2.5","2920","5500","2030","890","1957","1250000"
"5","3.5","5430","10327","4010","1420","2007","1240000"
"4","3.75","4260","9800","4260","0","2008","1070000"
"4","3.5","4440","10660","4440","0","2003","1040000"
"5","4.5","4030","13474","4030","0","2000","989000"
"4","2.5","2230","4372","1540","690","1935","900000"
"3","2","2783","11177","2783","0","1910","840000"
"4","1.75","2000","3988","1000","1000","1958","810000"
"4","2.25","3300","8365","3300","0","2014","760000"
"4","1.75","2100","4750","1340","760","1975","759000"
"4","2.5","3020","7465","3020","0","2004","750000"
"4","2.75","2910","18700","2210","700","1957","749950"
"3","2.75","2820","5348","2820","0","2008","749000"
"4","2.75","2700","6000","2100","600","1910","749000"
"2","2.5","2150","5760","2150","0","2010","741500"
"4","2.5","3360","15091","3360","0","1997","740000"
"3","1.75","2320","10900","2320","0","1935","737500"
"2","2.25","2290","9772","2290","0","2007","737000"
"4","3.25","4280","47179","3050","1230","2002","734950"
"4","2.5","3350","35298","3350","0","1985","720500"
"3","1","1410","7200","1410","0","1901","700000"
"4","3.5","3650","38546","2550","1100","1996","696000"
"4","2.75","3710","7984","3710","0","1999","692500"
"3","2","1780","5720","980","800","1925","680000"
"4","2.75","2100","4480","1780","320","1928","679000"
"3","1","1240","3500","1240","0","1927","660000"
"4","2.5","2510","4543","2510","0","2002","660000"
"4","2.75","3510","9400","3510","0","2014","659950"
"4","2.5","3080","35430","3080","0","1997","635000"
"3","1.75","1710","8767","1710","0","1986","630000"
"4","1","1600","5500","1600","0","1946","625000"
"3","1.75","3160","76230","2160","1000","1978","625000"
"3","2","2250","14274","1500","750","1964","624800"
"3","2.5","2630","5827","2630","0","2001","610000"
"3","3.25","1830","1804","1830","0","2014","599950"
"7","2.5","2580","5750","1880","700","1901","599000"
"4","3.25","3730","4560","2760","970","2015","595000"
"4","2.5","2720","10006","2720","0","1989","594950"
"3","2.5","2650","9380","1680","970","1975","590000"
"3","2.5","2600","5100","2600","0","1998","583000"
"3","1.75","1850","5100","1020","830","1909","580000"
"6","3.75","4000","6015","3080","920","2004","570000"
"3","3.25","2220","8227","1770","450","1929","569000"
"3","2.5","2500","7394","2500","0","1990","565000"
"4","2.5","2570","5250","2570","0","1990","561000"
"3","2.5","1960","6058","1960","0","2002","560000"
"2","1","1010","9219","1010","0","1960","560000"
"3","2","1970","4166","1270","700","1929","550000"
"4","1.75","2150","9000","1110","1040","1966","550000"
"4","1","1440","3600","1440","0","1924","550000"
"3","2.5","2760","17377","2760","0","2002","545000"
"3","2.5","3010","7014","3010","0","2009","538000"
"3","2.5","1790","3078","1790","0","2010","530000"
"4","2.75","2910","6308","1640","1270","1985","525000"
"4","1.75","1710","10440","1710","0","1955","525000"
"4","2.5","3670","9958","3670","0","2005","525000"
"3","1.75","2140","40098","1490","650","1950","507000"
"2","1.75","1350","4614","1350","0","2008","498800"
"3","2","2660","192099","2660","0","1964","495000"
"4","2.5","2540","5001","2540","0","2005","487000"
"4","2.5","3560","12047","3560","0","1988","486000"
"5","2.75","2550","7725","1390","1160","1967","480000"
"4","2.25","2380","17199","1530","850","1979","470000"
"4","2.5","2100","8400","1240","860","1976","468000"
"4","2.5","1980","6660","1980","0","1974","463000"
"5","2.5","2850","209523","1930","920","1925","450000"
"3","2.5","1460","7573","1460","0","1983","450000"
"3","2.25","1920","8223","1920","0","1989","443000"
"3","1.5","1270","1413","1270","0","2007","440000"
"4","2.5","2550","5200","2550","0","2009","435000"
"2","1","1320","8830","1020","300","1939","425000"
"3","1.75","1510","6360","1510","0","1954","420000"
"4","1.5","1840","11367","1840","0","1950","415000"
"4","3.5","3360","9767","2450","910","1990","412000"
"3","1.75","1660","6250","830","830","1980","410000"
"5","3.25","3320","11340","2480","840","1999","409124"
"3","2","1760","6875","1760","0","1967","400000"
"5","2.75","1970","5400","1320","650","1986","399950"
"2","1","930","6380","930","0","1940","395000"
"4","2.75","1970","37026","1970","0","1961","395000"
"2","1","780","3910","780","0","1918","380000"
"3","2.5","1530","2913","1530","0","1986","379000"
"3","2.25","1390","1484","1390","0","2007","374950"
"3","1.5","1550","4980","1080","470","1978","359000"
"3","2.5","1590","3411","1590","0","2000","356000"
"3","1","1600","7324","1600","0","1958","340000"
"3","1","1370","6780","1370","0","1930","335500"
"1","1","730","1942","730","0","2008","321500"
"3","1.5","1460","9908","1460","0","1952","310000"
"3","2.25","1980","8755","1300","680","1963","309000"
"3","1","1450","7200","1010","440","1969","306000"
"3","1.5","1800","12196","1800","0","1966","305000"
"4","1.75","1820","5015","1190","630","1926","300000"
"3","2.5","1460","3044","1460","0","2000","299880"
"2","1","800","6500","800","0","1953","295000"
"3","1.5","1950","15954","1950","0","1959","290000"
"5","1.5","1730","9230","1010","720","1962","287000"
"4","1.75","1880","8800","1130","750","1960","284000"
"3","1.5","1500","10018","1500","0","1957","284000"
"4","2","2030","8426","2030","0","1944","275000"
"3","1","1200","7800","1200","0","1954","275000"
"4","2.5","1660","9253","1660","0","1978","270000"
"4","1.75","1120","8250","1120","0","1966","252000"
"3","1","990","8062","990","0","1960","250000"
"3","2.5","1610","7223","1610","0","1994","245000"
"2","1.75","1460","7926","1460","0","1987","237950"
"3","1.5","1940","9887","1140","800","1969","232500"
"4","2.25","2010","7688","1170","840","1979","229000"
"3","1","990","4440","990","0","1943","226550"
"4","1.5","1860","5040","1860","0","1920","215000"
"3","1.75","1770","29004","1770","0","1959","215000"
"3","1","1200","7280","1200","0","1967","215000"
"2","1","840","11600","840","0","1952","187000"
"4","1","1600","10183","1600","0","1966","154950"
"3","0.75","490","38500","490","0","1959","150000"
"3","1","960","27442","960","0","1970","137124"
"6","4.5","4800","9097","3580","1220","2007","1980000"
"4","3","4460","6833","3140","1320","1955","1910000"
"4","2.75","5470","18200","3730","1740","1992","1610000"
"5","4.25","6070","171626","6070","0","1999","1550000"
"6","4.25","5720","10213","4170","1550","2004","1330000"
"3","3","3460","5353","2850","610","2007","1250000"
"4","3.5","1800","6400","1800","0","1984","958000"
"6","2.5","2640","3680","1760","880","1922","880000"
"4","2.5","3360","22111","3360","0","1994","879000"
"5","3","2960","15152","2960","0","2004","875000"
"5","2.25","3480","9200","3480","0","1979","860000"
"5","2","2310","13430","2310","0","1966","850000"
"5","3.25","4230","10260","3860","370","1996","847700"
"4","3.5","3840","85728","3840","0","1998","840000"
"3","2.75","2220","4000","1700","520","1914","800000"
"3","2.5","1370","1911","1370","0","1907","797000"
"6","2.75","2980","175421","2480","500","1916","775000"
"5","2.5","3000","7912","1610","1390","2007","770000"
"4","1.5","2130","5000","2130","0","1920","749000"
"3","1.5","1830","4000","1350","480","1910","740000"
"3","2.5","2820","8159","2820","0","2004","735000"
"2","1.75","1950","2719","1010","940","1919","725000"
"3","1.75","1690","8489","1690","0","1959","725000"
"4","2.5","3340","8930","3340","0","1999","720000"
"3","2.25","1810","9845","1810","0","1959","713400"
"4","2.5","2870","8995","1870","1000","1968","710000"
"4","3.5","3310","21050","2400","910","1992","695000"
"3","1.75","1920","4500","960","960","1924","675000"
"4","2.5","2390","5249","2390","0","2006","675000"
"3","2.5","1420","1438","1280","140","2003","670000"
"3","2","2320","10960","1510","810","1956","657500"
"4","2.5","2640","25038","2640","0","1995","657000"
"4","2.25","2170","4080","1920","250","1980","655000"
"4","2","1840","5419","920","920","1942","639000"
"4","2.75","2600","36583","1580","1020","1976","610000"
"2","2.5","2410","102366","1940","470","1912","600000"
"5","3.5","3340","5000","2580","760","2012","592000"
"4","1","1140","5500","1140","0","1916","569950"
"2","2","1670","4996","1670","0","2004","554000"
"2","2","2930","14057","1680","1250","1980","545000"
"3","2.5","2060","7184","2060","0","1987","545000"
"3","2","2800","185130","2320","480","1996","540500"
"5","3.25","2850","4551","2370","480","2006","535000"
"4","1.75","2280","5959","1250","1030","1947","525000"
"2","1.5","1340","3600","1340","0","1903","525000"
"2","1","1240","57000","1240","0","1962","505000"
"3","1.75","1640","47044","1640","0","1989","500000"
"4","1.75","1520","7700","1520","0","1967","499950"
"3","2","1880","9659","1180","700","1951","475000"
"5","2.5","2690","11745","1790","900","1960","469000"
"2","1","840","3840","840","0","1926","445000"
"4","2","1560","7500","1560","0","1968","439000"
"4","2.5","2700","6515","2700","0","1998","426500"
"2","2.5","1500","3608","1500","0","2005","418000"
"4","1.75","2320","5490","1160","1160","1956","416100"
"3","1","1470","6500","1470","0","1953","410000"
"4","2","2680","13680","2350","330","1943","400000"
"3","2","3110","44967","3020","90","1999","379900"
"4","1.5","1280","5460","1080","200","1920","379000"
"4","2.5","2380","10800","2380","0","2005","360000"
"3","2.5","2110","4038","2110","0","1989","355000"
"4","1","1170","8147","1170","0","1959","350000"
"4","2.5","2800","9538","2800","0","1993","350000"
"4","2","1720","7210","860","860","1971","350000"
"3","2.5","1500","2255","1500","0","2005","348000"
"3","1.75","3140","8571","1670","1470","1985","345000"
"2","1.5","1320","826","1100","220","2008","342500"
"3","2.25","1420","3433","1420","0","1981","336500"
"3","2.5","2340","6837","2340","0","1992","315000"
"3","1.5","1480","6752","1480","0","1959","307150"
"4","2.5","1714","3080","1714","0","2009","307000"
"2","2","970","9750","970","0","1940","303000"
"2","1","740","4459","740","0","1915","295000"
"3","2.25","1720","7885","1720","0","1983","290256"
"2","1","670","6300","670","0","1942","279000"
"4","2.5","1889","6000","1889","0","2012","277950"
"4","2.5","1830","3868","1830","0","2007","275000"
"3","2.5","1550","3402","1550","0","2009","273500"
"3","2.5","1530","6000","1530","0","1991","265000"
"3","1.75","1580","9187","1180","400","1993","263000"
"3","2.5","1490","8102","1490","0","1990","260000"
"3","2","1440","5457","1440","0","1986","250000"
"3","1","1010","8711","1010","0","1944","250000"
"2","1","960","21850","960","0","1947","242000"
"3","2.25","1630","7900","1130","500","1973","231500"
"4","2","2090","6630","1070","1020","1974","200000"
"2","1","860","10400","860","0","1983","195000"
"3","1","920","4875","920","0","1978","152000"
"3","1","1200","9527","1200","0","1959","150000"
"2","1","740","6250","740","0","1942","114975"
"4","4.75","4575","24085","3905","670","1926","2920000"
"8","2.75","4040","20666","2020","2020","1962","1650000"
"4","3.5","4410","12426","3420","990","1996","1500000"
"3","3.25","3700","2264","2280","1420","1998","1480000"
"6","3.5","4860","11793","3860","1000","1998","1070000"
"5","4.5","4300","12250","4300","0","2004","975000"
"4","2.75","3520","5500","3520","0","2014","859990"
"3","2.5","3190","6899","3190","0","2014","814842"
"5","2.5","2900","5901","2900","0","2006","808900"
"4","2.25","3220","8436","3220","0","1968","800000"
"4","3.5","3560","6098","3560","0","2006","790000"
"4","2.5","3500","9198","3500","0","2004","790000"
"3","3.5","3190","6776","3190","0","1998","780000"
"3","1.75","2050","9870","2050","0","1959","745000"
"5","2.25","3320","60984","3320","0","2000","665000"
"3","1","1060","9123","1060","0","1952","641200"
"4","2.75","3040","7274","2320","720","1986","640000"
"4","3.25","3420","6752","3030","390","2012","635000"
"3","1.5","1230","3060","910","320","1927","625000"
"4","3","2530","4166","1470","1060","1976","625000"
"4","2.25","2210","10039","1710","500","1967","620000"
"4","2.5","2090","6906","2090","0","1992","601000"
"5","2.5","2780","12335","1590","1190","1968","582000"
"7","2.75","2310","2400","2310","0","1915","580000"
"3","2.25","1790","9580","1790","0","1984","578000"
"4","1.75","2440","8100","1620","820","1960","575000"
"4","2","1790","7800","1790","0","1972","570000"
"4","1.75","2140","7102","1070","1070","1948","565000"
"5","1.5","2240","6337","1280","960","1956","534950"
"4","2.25","2130","8640","1430","700","1969","530000"
"3","1.5","1560","9350","1220","340","1969","525000"
"5","3","2360","5000","1390","970","2008","504600"
"3","1.5","1320","8100","1320","0","1951","500000"
"4","2.5","2090","4196","2090","0","2006","489900"
"3","3","2440","15540","2440","0","1992","483000"
"4","2.75","2200","16288","1290","910","1980","475000"
"3","3.25","1380","1121","1380","0","2008","475000"
"2","2.5","1140","1181","1140","0","2007","467000"
"4","2.5","2230","64438","1230","1000","1978","464950"
"3","2.5","1610","2527","1080","530","2005","460000"
"3","2.5","1810","914","1380","430","2008","450000"
"3","1.75","1450","6829","1450","0","1983","440000"
"3","2.25","1900","7225","1220","680","1970","440000"
"4","1","1760","7216","1090","670","1947","429950"
"4","1.75","1430","10500","1130","300","1960","412000"
"3","1.5","1600","7500","1600","0","1966","405000"
"3","2.5","2020","3000","1010","1010","1910","400000"
"3","2.5","1470","1256","930","540","2006","397500"
"4","2.5","2240","5500","2240","0","2013","389950"
"3","2","1860","7400","930","930","1922","385000"
"2","1","1470","81021","1470","0","1949","380000"
"3","1","1170","1105","1170","0","1965","370000"
"3","1.75","1640","4860","1200","440","1965","369950"
"4","2.5","2650","10459","2650","0","1989","350000"
"4","2.5","2490","5812","2490","0","2000","344200"
"4","2.5","2340","9748","1610","730","1981","339900"
"3","2.25","2090","10120","1290","800","1979","339000"
"4","2.5","1920","4600","1920","0","2002","329950"
"3","2.25","1930","3462","1930","0","2004","326000"
"3","1.75","1640","53400","1640","0","1966","319000"
"3","1.5","1480","1722","1480","0","2007","319000"
"3","1.75","1660","37642","1660","0","1991","315000"
"3","1.75","1810","41800","1210","600","1980","314000"
"4","2.25","2560","8927","1790","770","1976","303000"
"3","2.5","1600","9830","1600","0","1993","299950"
"3","2.5","1650","4725","1650","0","2011","299000"
"2","1","840","3844","840","0","1919","290000"
"3","1.75","1220","7004","1220","0","1966","289900"
"3","2.5","1690","7165","1690","0","1992","270000"
"3","2","1680","19978","880","800","1948","258000"
"2","1","1030","8786","1030","0","1956","250000"
"3","1","920","4429","920","0","1952","250000"
"3","1.75","1440","11325","1440","0","1966","246000"
"3","2.5","2350","9051","1570","780","1966","235000"
"3","1.5","1330","9548","1330","0","1967","230000"
"3","1.75","1140","9800","1140","0","1968","206000"
"3","1.5","1820","8585","1820","0","1962","205000"
"2","1","890","6430","890","0","1935","199990"
"2","1","810","6697","810","0","1923","194900"
"2","1","640","7768","640","0","1942","165000"
"2","1","950","2784","950","0","1972","162950"
"3","1.5","1480","7000","1000","480","1980","160000"
"4","2.75","3010","7200","3010","0","2014","839950"
"4","2.5","2900","23488","2900","0","1992","690000"
"2","1","1290","6272","890","400","1922","492000"
"2","1","900","6000","900","0","1944","451000"
"3","2.5","1320","1683","1270","50","2004","369000"
"3","2.25","1530","4580","1530","0","2011","335000"
"3","1","950","8000","950","0","1968","335000"
"4","1.5","2220","6811","1270","950","1961","320000"
"3","1.75","1420","7920","1420","0","1962","235000"
"4","2.25","2030","6479","2030","0","1983","579000"
"3","2.5","1870","3439","1870","0","2005","300000"
"3","1.75","1720","13104","1720","0","1962","285000"
"4","4.5","4650","7660","3640","1010","2008","1750000"
"4","2.25","3470","8000","2360","1110","1906","1730000"
"5","3.5","5930","13288","3920","2010","1996","1520000"
"4","4.25","3650","5328","2330","1320","1907","1520000"
"2","3.25","2700","3444","2700","0","1990","1370000"
"4","2.5","3730","16950","3730","0","1990","1260000"
"3","3","4560","16339","4040","520","2001","1220000"
"3","2.5","3430","28718","3430","0","1984","1200000"
"5","3.25","3070","5000","2050","1020","2006","1110000"
"4","3.5","2210","7597","1550","660","1977","1100000"
"4","4","5320","20041","5320","0","2003","1060000"
"4","3.25","3600","18645","3000","600","2013","1030000"
"5","2.5","2750","6000","1750","1000","1904","980000"
"4","2","2190","4560","2190","0","1910","980000"
"3","3.25","3330","15093","3330","0","1988","950000"
"4","3.25","3820","15293","3820","0","2003","950000"
"3","2.5","3940","10360","3110","830","1992","933399"
"3","3.5","3790","10829","3790","0","1993","929950"
"3","3.25","4030","12765","2800","1230","1975","890000"
"4","3","2720","183823","2720","0","1975","850000"
"3","2.25","2220","3707","1620","600","1919","850000"
"4","1.75","1760","4080","1760","0","1906","810000"
"6","2.75","3040","36721","1760","1280","1958","799950"
"4","2.5","2880","8400","2050","830","1955","775000"
"3","2.75","3010","12432","1890","1120","1970","745000"
"5","3","2970","10335","2970","0","2000","726000"
"4","2.75","2840","8800","2840","0","2008","718500"
"3","1","1640","4000","1640","0","1909","716100"
"3","2.5","2550","5376","2550","0","2004","711000"
"2","1.75","2140","5000","1000","1140","1930","675000"
"4","2.5","2900","5505","2900","0","2002","675000"
"2","1.75","1650","7500","1000","650","1959","670000"
"4","1.75","2010","5070","1300","710","1963","650000"
"3","2.5","2540","8073","1880","660","1937","650000"
"4","2.5","2530","6500","1720","810","1975","650000"
"1","1","920","91476","920","0","1996","650000"
"3","2.5","1910","4363","1910","0","2006","650000"
"4","2.5","2510","35020","1610","900","1977","630000"
"4","2.5","2660","22050","2660","0","1996","629000"
"3","1.75","1950","8480","1250","700","1962","615000"
"3","1.75","1630","1500","1630","0","2014","610000"
"4","2.75","3030","21780","3030","0","1986","608250"
"2","2","1270","5500","1270","0","1921","605000"
"3","2.5","1640","3804","1640","0","1998","602000"
"4","1.5","1770","6014","1240","530","1946","600000"
"5","2.5","2950","72309","2950","0","2006","599000"
"4","1.75","3140","12519","2320","820","1951","585000"
"3","2","2040","4800","1020","1020","1925","580000"
"3","2.5","3200","18750","2660","540","1967","580000"
"3","1","1140","5395","1010","130","1909","576000"
"4","1.5","2810","7140","1490","1320","1954","575000"
"5","2.5","2990","7500","1800","1190","1972","575000"
"4","2.25","2070","1230","1500","570","2013","575000"
"4","2.5","2640","4200","2640","0","1998","570000"
"4","1.75","1980","2700","1210","770","1931","560000"
"3","2.5","2120","4310","2120","0","2001","559950"
"3","1.75","1570","15500","1570","0","1968","555000"
"3","1.75","1680","4800","1400","280","1960","550000"
"3","1.75","1410","5000","810","600","1923","550000"
"2","1.75","1460","4800","850","610","1950","540000"
"3","2","1540","8400","1180","360","1968","529950"
"3","2.5","3070","22098","3070","0","1995","529000"
"5","2.5","2360","10081","1180","1180","1961","525000"
"3","1.75","1510","8250","1510","0","1962","516130"
"3","2.5","1540","6100","770","770","1944","515000"
"3","2","1620","8400","1180","440","1968","498000"
"3","1.5","2240","11250","1620","620","1956","497000"
"4","2.25","1960","10275","1960","0","1965","490000"
"4","2.5","2846","85377","1976","870","2000","482000"
"3","1.75","1650","9600","1650","0","1977","476000"
"3","1","1480","13280","1480","0","1940","455000"
"2","1.5","1310","1264","1120","190","2006","450000"
"4","2.5","2448","4949","2448","0","2014","447055"
"3","2.5","1740","3043","1740","0","2012","447000"
"3","2","1870","7080","1210","660","1969","432000"
"3","2.5","1440","7320","1440","0","1954","430000"
"4","1.5","1540","7886","1540","0","1967","415000"
"3","2","1520","3200","1520","0","1996","413000"
"3","2","1270","10227","1270","0","1968","410000"
"2","1.75","1510","5319","1510","0","1978","406500"
"2","1.75","1610","4104","950","660","1996","397000"
"4","2.5","2200","6018","2200","0","2010","396800"
"3","2.25","1640","2875","1240","400","1983","390000"
"3","1","1030","3000","830","200","1924","385000"
"3","1","1020","4800","1020","0","1944","380000"
"3","2.5","1800","2791","1800","0","2011","379900"
"3","1","1060","9506","1060","0","1959","364500"
"3","2.25","2130","8466","1290","840","1983","360000"
"3","1","1400","4980","950","450","1943","359950"
"3","1","940","6695","940","0","1959","358000"
"3","2.25","1322","1796","1087","235","2005","350000"
"4","2.25","2210","11700","2210","0","1967","336000"
"4","2.5","1830","4500","1830","0","2004","335000"
"3","1.75","1010","7171","1010","0","1967","325000"
"3","2","1770","7251","1770","0","1990","320900"
"3","1.75","2000","9760","1400","600","1978","320000"
"4","2.5","2330","4606","2330","0","2004","308000"
"4","2.75","2420","8438","2420","0","1996","307999"
"3","1","1240","8840","1240","0","1952","294950"
"3","1","1300","5782","1300","0","1959","281000"
"3","1.75","1430","39160","900","530","1925","279000"
"3","1.5","1540","13475","1540","0","1972","270000"
"2","1","1150","3600","1150","0","1910","270000"
"3","2.5","1520","8720","1080","440","1981","269950"
"3","1.75","1170","8148","1170","0","1952","265000"
"3","1","1170","9730","1170","0","1968","252000"
"3","1.5","1010","10350","1010","0","1969","240000"
"4","1","1280","8316","1280","0","1950","239000"
"2","1","710","14000","710","0","1953","239000"
"3","1","920","6612","920","0","1948","210000"
"2","1","820","5700","820","0","1942","208000"
"1","0.75","590","5650","590","0","1944","202000"
"1","1.5","1010","1157","950","60","2007","200000"
"3","1","1510","9100","1510","0","1966","199000"
"3","1","1250","7015","1250","0","1958","170000"
"3","1.5","1370","7439","1370","0","1963","168000"
"3","2.25","3170","5000","2230","940","1975","1600000"
"5","4","3760","22763","1910","1850","1969","1380000"
"5","1","1670","6400","1670","0","1919","1300000"
"4","2.5","4240","43995","4240","0","1989","1160000"
"3","2.5","3050","7410","1950","1100","1950","975000"
"5","3.5","3750","9612","2030","1720","1981","942500"
"5","3","3850","9457","2910","940","1963","925000"
"3","2.25","2380","11200","2380","0","1963","921000"
"4","2.5","3560","6786","2930","630","2014","907687"
"4","1.75","2260","6600","1220","1040","1948","864000"
"4","2.5","3290","8147","3290","0","2003","856500"
"6","3.25","4920","20590","2730","2190","1960","850000"
"4","2.25","2290","7089","1490","800","1948","840500"
"5","2.5","2890","9800","2890","0","2003","825000"
"3","1.5","1370","8671","1370","0","1955","815000"
"5","1.5","1720","5000","1720","0","1915","775000"
"4","1.75","2670","6250","2020","650","1941","750000"
"4","2.25","2290","10409","2290","0","1972","745000"
"4","2.5","3050","8000","3050","0","2007","740000"
"4","2.5","2770","9532","2770","0","1988","711000"
"4","2.5","3420","222156","3420","0","2002","650000"
"4","2.75","2330","3917","2330","0","2004","645000"
"2","1","1420","5332","1070","350","1953","641000"
"4","2.5","2500","7417","2500","0","1991","640000"
"5","2","1900","5000","1720","180","1957","630000"
"4","2.5","2570","5520","2570","0","2000","625000"
"3","2","1880","4000","1280","600","1950","625000"
"3","1.5","1800","4700","1200","600","1941","607500"
"4","2.75","2150","16728","1240","910","1982","607000"
"3","1","940","19000","940","0","1945","600000"
"2","1","1180","2160","940","240","1909","600000"
"3","2.5","2150","5193","2150","0","1995","587000"
"3","2.5","2050","11690","2050","0","1989","585000"
"4","2.5","2550","56628","2550","0","2001","575000"
"4","2.5","2350","6624","2350","0","1990","561600"
"3","2.5","2620","11056","2620","0","1988","557500"
"3","2","2380","17950","2110","270","1934","550000"
"3","2.5","2660","20369","2660","0","1992","545000"
"4","2.75","3180","13348","3020","160","2004","510000"
"4","2.75","2910","7467","2910","0","2013","504058"
"3","2.5","1620","2640","1620","0","1900","498000"
"5","1.75","2760","18112","1510","1250","1968","495000"
"4","2.25","2800","10800","1680","1120","1977","490000"
"3","2.5","1930","7266","1930","0","2005","490000"
"5","3.25","2180","7200","2180","0","1982","473000"
"3","2.25","1780","8784","1230","550","1977","470000"
"2","1.5","1140","1058","1140","0","2005","466000"
"2","1","1110","5413","890","220","1937","448000"
"4","1.75","2430","13211","2430","0","1909","445000"
"3","2","2190","13673","2190","0","1994","432000"
"3","2.5","1710","12677","1710","0","1996","431000"
"2","2","1440","213008","1440","0","1990","430000"
"3","2.5","1970","2752","1970","0","1978","425500"
"3","1.75","1320","6030","1320","0","1969","409950"
"2","2.25","1640","2128","1640","0","1974","409000"
"3","1.5","1010","8108","1010","0","1954","405500"
"3","1.75","1480","2211","1480","0","1995","402500"
"5","1.75","2300","6720","2300","0","1905","400000"
"3","2","1590","87120","1590","0","1998","399950"
"4","1.75","1970","12409","1220","750","1968","396000"
"3","2.75","1950","12240","1250","700","1956","390000"
"1","1.75","1440","14258","720","720","1923","390000"
"4","1.75","2220","15600","1140","1080","1963","374000"
"4","1.75","1890","10550","1010","880","1969","372000"
"4","2.5","2130","4750","2130","0","2009","370000"
"3","2","1460","4350","1460","0","2008","362764"
"3","1","1600","5001","1080","520","1930","355000"
"3","3","3200","35782","2360","840","1978","350000"
"2","1.75","1080","7242","1080","0","1984","350000"
"4","1.75","1800","5210","1080","720","1979","340000"
"3","2","1130","9879","1130","0","1996","340000"
"3","1.75","1510","15744","1510","0","1985","330000"
"3","2.5","1256","1154","1256","0","2005","316750"
"3","1","1210","9730","1210","0","1953","310000"
"2","1.5","1090","1183","1090","0","2008","306000"
"3","1","1030","5350","1030","0","1924","305000"
"4","2.75","2030","9120","2030","0","1988","302000"
"3","1","1280","10500","1280","0","1941","291000"
"2","1.75","1440","11210","1130","310","1935","282500"
"3","2.5","2010","5399","2010","0","2006","282000"
"4","2.25","2670","10050","1420","1250","1962","275000"
"3","1.5","1060","6954","1060","0","1983","275000"
"3","1.75","1300","8099","1080","220","1976","275000"
"4","2","2440","9600","1220","1220","1963","274700"
"4","2","1870","6551","1870","0","2009","272000"
"3","1.75","1890","11875","1230","660","1979","271900"
"3","1.75","1790","7485","1330","460","1979","263000"
"2","1","940","15450","940","0","1926","252000"
"4","2.75","1910","7700","1000","910","1980","250000"
"3","2","1470","8000","1470","0","1974","245000"
"4","1","2240","7620","1120","1120","1966","242000"
"4","1","1400","7242","1400","0","1959","238000"
"3","1","1160","6132","1160","0","1958","237000"
"3","1.5","1060","9600","1060","0","1962","219000"
"3","1","1040","6800","1040","0","1951","212000"
"2","1","1060","8000","1060","0","1941","205000"
"4","2.5","1840","13493","1840","0","1994","190000"
"5","1.75","1990","5000","1990","0","1955","185000"
"3","1","1510","17040","1510","0","1975","185000"
"3","1","840","6500","840","0","1969","178000"
"3","1.5","1350","81549","1350","0","1966","170000"
"2","0.75","550","7980","550","0","1952","115000"
"3","3.5","3680","11491","3680","0","1999","1230000"
"3","2.5","2670","5000","2000","670","1942","1170000"
"5","3.25","4475","6642","4475","0","2014","1040000"
"5","3.25","2700","3650","2070","630","1926","950000"
"4","2.5","3670","49658","3670","0","1999","885250"
"4","1.75","2170","9525","2170","0","1960","842000"
"4","2.5","3650","7784","3650","0","2006","835000"
"3","2.5","1630","2640","1630","0","1919","800000"
"4","2.5","2290","13416","2290","0","1981","785000"
"4","2.5","2980","5000","2980","0","2006","765000"
"3","2.5","3090","13316","3090","0","1992","751000"
"3","2.5","2010","2263","1340","670","2014","749950"
"3","3","1660","1849","1660","0","2013","716000"
"4","2.5","2590","4498","2590","0","2004","700000"
"4","3.25","3250","5478","3250","0","2014","699188"
"3","1.75","1670","5375","1270","400","1952","699000"
"4","2.5","2170","8680","1220","950","1959","685000"
"4","3","2500","5000","1460","1040","1926","670000"
"3","1.75","1770","3880","1300","470","1963","667000"
"3","2.5","1730","3000","1730","0","1996","665000"
"4","2.75","3550","9400","3550","0","2014","659950"
"3","2","1410","4800","1410","0","1927","655000"
"3","1.75","2340","6750","1620","720","1914","645000"
"5","3","2460","7240","1840","620","1991","637000"
"3","2.5","1530","2978","1210","320","1997","635000"
"5","1.75","2490","24969","1540","950","1959","630000"
"3","1","1040","4240","860","180","1924","626000"
"4","3.5","4170","4524","3500","670","2007","623300"
"4","1.5","1350","8113","1350","0","1959","595000"
"5","2.25","2340","9225","2340","0","1973","572000"
"3","3","2110","4000","1110","1000","1965","565000"
"4","1","1540","2452","1540","0","1906","565000"
"3","2.5","1960","9686","1460","500","1989","560000"
"3","1","1600","5000","1110","490","1947","550000"
"3","2.5","2290","6328","2290","0","2001","550000"
"3","1.5","1380","3031","1380","0","1929","549900"
"4","2.5","2360","43088","2360","0","1977","542126"
"4","2.5","2290","4450","2290","0","2004","540000"
"5","2.25","2500","8621","2500","0","1968","525000"
"4","1.75","1240","4532","1240","0","1944","520000"
"2","1","1360","22508","1360","0","1932","520000"
"3","2.25","1850","10855","1370","480","1985","520000"
"2","1","833","143947","833","0","2006","517534"
"3","2.5","2360","11254","2360","0","1990","515000"
"3","2.25","1710","4561","1710","0","1994","500000"
"3","2.5","1800","11034","1800","0","1987","485000"
"3","2.5","1940","10035","1940","0","1994","480000"
"4","2.5","3620","16000","3620","0","1976","480000"
"4","2.5","3274","4950","3274","0","2014","478830"
"2","1.75","1710","8645","1510","200","1923","475000"
"3","1","1010","5000","1010","0","1952","470000"
"3","1.75","1680","2400","1170","510","1929","469000"
"3","1","1490","10650","1150","340","1963","460500"
"5","2","1910","12264","1010","900","1963","460000"
"4","1.75","2390","23899","1750","640","1949","450000"
"2","2","1900","7740","1150","750","1923","450000"
"3","1.5","1520","7903","1000","520","1955","450000"
"4","1.5","1860","12197","1860","0","1964","443000"
"3","1.75","1950","19747","1150","800","1979","440000"
"3","2.25","1550","1469","1550","0","2004","430000"
"3","1","1350","7085","1350","0","1944","427500"
"2","1","2230","11472","2230","0","1951","426000"
"4","2","1590","10331","1590","0","1956","414050"
"4","2.5","2311","4396","2311","0","2014","399440"
"3","2.5","1350","874","1270","80","2006","389500"
"3","2.5","2220","20531","2220","0","1998","382450"
"3","1.75","1790","7679","1790","0","1953","382000"
"3","1.75","2040","12065","2040","0","1987","379950"
"3","2.5","1330","816","1330","0","2004","375000"
"3","1","1520","10798","1520","0","1953","375000"
"3","1","1380","30940","1380","0","1976","365000"
"3","1.75","1520","12282","1220","300","1978","360000"
"4","1.75","2140","49658","2140","0","1959","360000"
"3","1","1070","10125","1070","0","1961","357500"
"3","1","1160","10518","1160","0","1960","351000"
"2","2.5","1290","1445","1290","0","1999","350500"
"3","1.75","1970","10800","1300","670","1979","350000"
"3","1","1790","3876","1090","700","1904","350000"
"3","1","1010","7200","1010","0","1968","347000"
"3","1","1120","10176","920","200","1905","345000"
"3","1","1010","9134","1010","0","1975","340000"
"3","2.25","2820","11625","2820","0","1986","336000"
"3","2.75","2850","4549","1540","1310","1989","335000"
"3","1","1030","8164","1030","0","1950","332500"
"4","2.5","2160","6825","2160","0","1994","325000"
"4","1.75","1310","9690","1310","0","1967","323000"
"4","2.75","2610","9077","1310","1300","1987","320000"
"3","2.5","1820","6400","1570","250","2008","320000"
"4","2","1780","7350","900","880","1974","318500"
"3","2.5","2090","4590","2090","0","2005","300000"
"1","1","1110","5421","1110","0","1935","293000"
"2","1.5","1010","1309","860","150","2007","289000"
"2","1","1000","31838","1000","0","1962","286300"
"4","1.75","1850","7350","1050","800","1965","270000"
"3","2.25","1740","9672","1110","630","1963","269900"
"3","1.75","1890","93218","1890","0","1964","267300"
"3","1.75","1100","10968","1100","0","1984","260000"
"3","2.5","1578","7340","1578","0","2010","259950"
"3","1.75","1240","4000","1240","0","1986","259000"
"2","1","990","10556","990","0","1981","250000"
"3","1","1590","11200","1590","0","1961","247200"
"4","1.75","1400","54014","1400","0","1935","242025"
"2","1","1800","9236","1800","0","1954","228000"
"3","1.5","1410","8800","1410","0","1965","226740"
"3","1.5","1500","15000","1500","0","1952","215000"
"2","1","1450","4750","850","600","1950","210000"
"3","2.75","2270","13590","1300","970","1948","199950"
"3","1","1170","3330","1170","0","1969","192950"
"4","1.75","1850","7500","1850","0","1954","181100"
"3","1","890","7110","890","0","1957","169000"
"2","1","930","7740","930","0","1932","105500"
"2","3","2210","3917","1500","710","2008","1260000"
"6","3.5","4310","7760","3260","1050","2013","1170000"
"4","3.25","3190","11774","2610","580","1956","1100000"
"4","3.25","4800","12727","4800","0","2011","1080000"
"4","2.75","3090","16538","2590","500","1919","1000000"
"3","2.5","2160","6000","1880","280","1939","990000"
"5","2.5","2900","9799","1450","1450","1959","968000"
"4","2","2330","5000","1720","610","1925","891000"
"5","2.75","2830","6137","2830","0","2010","820000"
"2","1.75","1550","6000","1550","0","1920","805000"
"4","2.5","3160","16564","3160","0","1987","795000"
"4","2.75","2900","17400","2410","490","1978","785000"
"4","3.5","4130","77832","4130","0","2011","775000"
"4","3.5","3950","12320","3950","0","2001","771150"
"5","1.5","2160","5000","2160","0","1926","770000"
"3","2.5","3680","35617","2390","1290","1985","770000"
"3","1.75","2080","5687","2080","0","1924","695000"
"3","2.25","2260","13209","2260","0","1977","675000"
"4","2.5","2470","4945","2470","0","2012","669000"
"4","2.5","2430","8000","2430","0","1992","658100"
"3","1.75","1480","7475","1480","0","1943","656000"
"4","2.5","2860","14000","2860","0","1995","645000"
"4","2","2260","8457","2260","0","1992","635000"
"4","2.25","2240","5000","2240","0","2013","635000"
"3","2.25","1270","1566","1060","210","2014","625504"
"3","2.5","1910","3427","1910","0","2001","615000"
"5","3.5","3610","52595","3610","0","1989","587000"
"5","2.75","3550","9600","3550","0","1960","580000"
"3","1.75","2100","6874","1300","800","1943","580000"
"3","2.25","2110","2850","2110","0","2001","525000"
"2","1.75","1210","131115","1210","0","1950","510000"
"3","2.25","1760","11946","1760","0","1978","500000"
"2","1.5","1590","4500","920","670","1946","490000"
"3","3.25","1740","13457","1360","380","2007","470000"
"6","3","2300","3404","1600","700","1920","464000"
"3","2.25","2100","8201","1620","480","1967","445000"
"3","1.75","1490","10844","1210","280","1974","445000"
"3","2.5","2170","5866","2170","0","2006","443500"
"3","2","1550","2401","1550","0","1996","440000"
"3","2.5","1650","3031","1650","0","2003","438000"
"4","1","1620","37075","1620","0","1943","430000"
"4","1","1800","12485","950","850","1955","425000"
"4","2.5","2550","7200","2550","0","2003","419500"
"5","3","3045","5030","3045","0","1999","414000"
"3","1.75","2110","19600","2110","0","1959","400000"
"4","1.75","1320","4800","870","450","1930","399700"
"4","2","1950","14258","1950","0","1961","392500"
"3","1.5","1360","2030","1360","0","2008","385000"
"6","3","2320","4502","1200","1120","1987","384000"
"4","2.25","1860","7980","1860","0","1966","380000"
"2","1","940","5120","940","0","1909","375000"
"1","1","720","3166","720","0","1920","375000"
"4","3.5","2720","6781","2100","620","1999","365000"
"2","1","760","6380","760","0","1941","361600"
"4","2.5","2080","4080","1040","1040","1962","360000"
"3","2","1930","15540","1260","670","1958","360000"
"3","1.75","1250","13775","1250","0","1990","350000"
"2","1.75","1740","6620","1740","0","2002","350000"
"3","2.5","1400","2036","1400","0","2003","346100"
"3","2","1410","10015","1410","0","1993","340000"
"5","2","1860","9000","1860","0","1980","338000"
"3","3","1430","4549","1430","0","2003","335000"
"4","2.25","2140","9377","2140","0","1986","322500"
"5","4","2900","9779","1950","950","1937","312000"
"3","2.25","1920","7840","1920","0","1982","299000"
"3","1","1370","11050","1370","0","1981","280000"
"3","2.5","1490","3840","1490","0","2002","265950"
"2","1","1600","7936","1600","0","1947","265000"
"3","1.75","2259","26831","1491","768","1908","262500"
"4","2.25","2160","8811","1360","800","1978","260000"
"3","1.5","1210","12500","1210","0","1962","257500"
"3","2","1420","6788","1420","0","1990","252000"
"3","1.75","2080","12522","2080","0","1950","249900"
"3","2","1220","6404","1220","0","1994","249900"
"2","1","860","6120","860","0","1948","245000"
"3","1","1510","15022","1510","0","1962","239000"
"3","1.5","1610","6132","1090","520","1959","238000"
"3","2","1110","8724","1110","0","1990","235000"
"2","1","670","5600","670","0","1903","235000"
"4","1","1270","6459","1270","0","1918","226000"
"3","2.25","1400","7205","1140","260","1985","220000"
"3","1.75","1290","7210","1290","0","1984","205000"
"5","1.75","1798","11232","1798","0","1967","199900"
"3","1.75","1300","6318","1300","0","1980","198000"
"2","1","830","4045","830","0","1943","150000"
"2","1","770","17334","770","0","1978","100000"
"5","3.25","3730","10626","3730","0","1963","2540000"
"4","4.25","5180","13077","4280","900","1998","1490000"
"4","2.75","3460","11350","1780","1680","1974","1090000"
"4","2.25","2420","9000","2000","420","1967","945000"
"3","2.75","3390","7000","1740","1650","1979","915000"
"5","2.5","3190","8160","3190","0","2014","865000"
"4","3.5","3980","209523","3980","0","2006","810000"
"4","2.5","3691","11088","3691","0","2013","800000"
"5","2.5","2590","7084","2590","0","2014","779380"
"3","2.5","2620","43832","2620","0","2013","750000"
"5","3","2640","3200","2140","500","1906","739375"
"4","2.5","3100","8529","3100","0","1990","735000"
"4","2.5","2740","11975","2740","0","1991","730000"
"3","1.75","1530","4000","1530","0","1985","725000"
"3","3.25","3230","5000","3230","0","2006","715000"
"3","2.25","3130","65775","3130","0","1978","710000"
"2","1.75","2320","6755","1380","940","1946","705000"
"4","2.5","2990","7231","2990","0","2001","698000"
"4","2.25","1930","3500","1540","390","1916","689888"
"4","1.5","1420","4923","1420","0","1928","679000"
"3","1.75","1850","2860","1210","640","1931","678100"
"4","2.5","2620","6114","2620","0","2011","675000"
"3","1.75","1280","2147","1280","0","1910","670000"
"2","2.5","2600","5000","1300","1300","1926","665000"
"3","2","1620","2640","1620","0","1929","665000"
"4","2.5","2500","8540","2500","0","1990","639000"
"4","2.5","2170","7275","1820","350","1978","638150"
"3","2.5","1730","1301","1730","0","2011","625000"
"3","1.75","2330","6000","1630","700","1940","605000"
"4","2.75","2910","10650","1780","1130","1975","590000"
"4","2.5","2290","11072","2290","0","1986","590000"
"3","2","2064","46173","2064","0","1903","567035"
"4","2.5","2580","5823","2580","0","2002","552250"
"3","2.25","1920","10961","1920","0","1981","549000"
"4","2.75","2790","6969","2790","0","2012","535365"
"5","2.75","2540","5022","1540","1000","1955","531000"
"3","2.25","1940","217800","1940","0","1990","529000"
"4","1.75","2220","6350","1110","1110","1959","526000"
"4","2.75","2310","5000","1480","830","1908","524000"
"4","2.5","2340","41600","1640","700","1977","522250"
"3","3","2100","2409","1660","440","2008","515000"
"3","2.5","2480","4136","2480","0","2009","498000"
"3","2.25","1870","9315","1350","520","1975","497000"
"4","3","3760","8804","2470","1290","2002","494500"
"3","1.75","1720","12540","1720","0","1956","490000"
"3","2.5","3160","13603","3160","0","2003","488000"
"4","1","1150","2560","1150","0","1909","485000"
"4","2.25","3380","9900","1690","1690","1969","470000"
"4","2.25","2340","13383","1170","1170","1983","465000"
"3","1.75","1540","9154","1540","0","1983","450000"
"4","1.5","1960","12688","1960","0","1962","442000"
"3","2.5","1600","2375","1600","0","2005","435000"
"2","1.75","1350","4003","1350","0","2004","430000"
"5","2.5","3860","42733","2300","1560","1955","430000"
"3","2.5","1400","7508","1400","0","1987","430000"
"3","1.75","1060","38644","1060","0","1983","420000"
"3","2.5","1970","4058","1970","0","2004","419000"
"2","1.75","1270","7560","1270","0","1932","416000"
"2","2","1130","1148","800","330","2007","411000"
"4","2.5","1900","15123","1900","0","1995","410000"
"4","2.25","2510","4090","1840","670","2012","410000"
"3","1.75","1620","8085","1210","410","1976","395000"
"5","2.5","2740","5400","2740","0","2005","378800"
"2","1","1040","5765","1040","0","1944","358803"
"5","1.75","1830","7986","1060","770","1962","354000"
"4","2.5","2380","6124","2380","0","1997","350000"
"2","1.75","1640","4176","1040","600","1948","349950"
"4","2.5","1830","5612","1830","0","2003","338900"
"2","1","1010","4000","1010","0","1947","337000"
"2","1","870","5635","870","0","1948","334850"
"4","2","1650","9305","1650","0","1960","334009"
"3","2.5","1870","4657","1870","0","2000","330000"
"4","1","1900","9000","1290","610","1948","327000"
"3","2.25","2450","49658","1770","680","1978","325000"
"4","2.75","2140","8100","2140","0","1990","304400"
"3","1.75","1370","9288","1370","0","1988","301950"
"4","1.5","1460","169448","1460","0","1958","300000"
"3","1.75","1290","1237","1060","230","2008","288790"
"3","2.5","1580","7000","1580","0","1992","280000"
"4","2.5","1810","13000","1470","340","1977","279000"
"3","1.5","1320","7695","1320","0","1959","275000"
"3","2.5","1770","8640","1420","350","1986","270000"
"3","1","990","9950","990","0","1961","269950"
"3","2.5","1720","6847","1720","0","1987","263000"
"2","1","1270","19602","1270","0","1977","260000"
"2","1","1440","43560","1150","290","1965","255500"
"3","2","1590","8670","1590","0","1994","255000"
"3","1.5","1240","8528","1240","0","1967","255000"
"3","2.5","1530","1116","1530","0","2005","255000"
"3","1","1160","7560","1160","0","1958","254000"
"3","1","1240","6195","1240","0","1948","230000"
"2","1","840","7425","840","0","1952","218450"
"2","1","1040","4590","1040","0","1954","210000"
"3","2","1250","7995","1250","0","1980","208000"
"3","1","1390","12145","1390","0","1964","199000"
"3","1","960","10761","960","0","1962","193000"
"2","1","1310","7697","850","460","1950","187300"
"2","1","1280","21750","1280","0","1912","170000"
"3","1","770","9750","770","0","1941","156000"
"3","1","880","7004","880","0","1950","128750"
"3","1.75","2140","3584","1070","1070","1952","680000"
"4","1","1640","6305","1640","0","1907","519000"
"4","2.5","2790","4650","2790","0","2004","374950"
"3","2.5","2060","5115","2060","0","2014","356250"
"3","1","860","7467","860","0","1944","205000"
"4","3.75","3450","8395","2640","810","1993","1670000"
"3","2.5","3470","12076","2560","910","1988","1050000"
"6","3.5","2410","6000","2220","190","1916","767500"
"4","2.5","2990","12788","2990","0","1988","760000"
"4","2","2320","7400","1620","700","1913","666570"
"4","3.5","3820","17745","2440","1380","1955","550000"
"3","1.75","2370","6360","1280","1090","1954","385000"
"4","1","1310","6000","1310","0","1940","370000"
"4","2.5","3320","8325","3320","0","1905","1800000"
"3","2.25","4470","22518","3240","1230","1953","1480000"
"3","2.5","2390","5500","1700","690","1952","1350000"
"4","3","2760","4905","1840","920","1938","1340000"
"5","3.5","4410","57063","4410","0","1990","1100000"
"4","3","3590","89640","3590","0","2005","879000"
"4","2.25","2720","8712","2720","0","1976","840000"
"4","3.75","3320","8030","3320","0","2005","802500"
"3","1","1175","10454","1175","0","1949","775000"
"3","2.5","2890","8470","2890","0","1996","775000"
"3","2.5","2050","15020","1600","450","1960","760000"
"4","3","2630","5772","2630","0","2006","731688"
"4","2.5","2440","7491","2440","0","1988","700000"
"3","2.75","2190","11060","1610","580","1973","700000"
"3","1.5","2540","9520","1500","1040","1959","690000"
"3","2","1740","3600","990","750","1923","677915"
"3","3.25","1720","1330","1030","690","2004","675000"
"5","3.5","3990","42436","2710","1280","2002","668000"
"4","2.5","2670","4410","2670","0","1999","668000"
"3","2.5","2430","12997","2430","0","1992","650000"
"6","2.5","3880","5700","3880","0","2003","635000"
"3","2","1730","12219","1730","0","1986","625000"
"4","2.25","2470","17008","2470","0","1979","625000"
"3","2.5","2360","12164","2360","0","1987","625000"
"3","2.5","1990","4040","1390","600","1926","579000"
"4","2.5","2590","5756","2590","0","2001","576000"
"3","2.5","1530","3296","1530","0","1998","570000"
"4","2.5","2440","7322","2440","0","1991","562500"
"3","2","1840","14985","1840","0","1968","560000"
"4","2.5","2280","9874","2280","0","1989","560000"
"4","1","2420","15520","2420","0","1945","550000"
"2","1.75","1140","936","940","200","2014","549900"
"4","2.5","3260","10032","1960","1300","1978","538000"
"3","2.5","2020","5613","2020","0","2003","528000"
"3","1.75","1620","5000","920","700","1954","514000"
"2","2.25","1170","1313","1170","0","2007","512000"
"4","2.75","2100","54014","1240","860","1978","503000"
"3","1","1710","5000","1140","570","1921","502000"
"3","2.5","2410","34848","2410","0","1976","500000"
"4","2.75","2760","18306","1630","1130","1978","492500"
"3","2.5","2870","5490","2870","0","2008","485000"
"2","2","1440","3720","1440","0","1983","475000"
"3","2.5","3800","104979","3210","590","2005","472000"
"4","2.5","3281","5354","3281","0","2014","471835"
"3","2.25","2080","111513","1680","400","1977","450000"
"4","2.5","3100","10000","3100","0","1978","449950"
"2","1","980","1600","980","0","2010","447000"
"5","3.5","3390","7950","3390","0","2003","439900"
"2","1","1650","5106","1090","560","1960","435000"
"3","1.75","2000","7111","1360","640","1956","427000"
"2","1","1150","6835","1010","140","1922","425000"
"3","2","1640","3440","1640","0","1987","408000"
"3","1.75","1390","4602","930","460","1981","400000"
"4","2.5","2154","4153","2154","0","2012","390000"
"3","2.5","2029","3906","2029","0","2014","384435"
"3","1.5","1370","9720","1370","0","1968","375000"
"3","2.5","1650","1793","1650","0","2007","370000"
"2","1","680","2550","680","0","1901","365000"
"3","1.75","1070","9000","1070","0","1978","361500"
"3","1.75","1330","7482","1330","0","1975","360000"
"3","2.75","2540","8604","2540","0","1991","359950"
"4","2.25","2470","7698","2470","0","1983","359900"
"3","2.5","1890","7053","1890","0","1992","347500"
"3","3.25","1500","1442","1150","350","2007","346000"
"4","2.5","2330","4907","2330","0","2013","337500"
"3","1.5","1560","9600","1560","0","1961","335000"
"4","2.25","2280","7500","1140","1140","1963","335000"
"4","2.5","2410","7846","2410","0","1992","334950"
"3","1.5","1510","344124","1510","0","1964","327000"
"3","1","1060","9663","1060","0","1967","326250"
"3","1.75","2050","6720","1050","1000","1939","324950"
"4","2.75","2200","8580","1860","340","1991","315000"
"4","2.5","1770","6666","1770","0","1989","309950"
"3","2.75","1850","8820","1850","0","1993","303000"
"5","1","1940","8875","1940","0","1957","300000"
"4","1.5","1530","9000","1530","0","1976","299800"
"2","1","820","6366","820","0","1952","294000"
"2","1","850","6800","850","0","1948","290000"
"3","1.5","1560","5000","1560","0","1961","265000"
"3","2.5","1740","6992","1740","0","1990","261500"
"4","1","1390","17739","1390","0","1958","261000"
"3","1","1400","9750","1400","0","1968","253000"
"3","2","1430","8919","1430","0","1992","246500"
"3","1","1090","10000","1090","0","1961","240000"
"3","2","1350","7686","1350","0","1989","233000"
"3","2","1450","11204","1450","0","2003","230000"
"3","1","1010","8848","1010","0","1968","229900"
"3","1","1440","11925","1440","0","1968","229900"
"4","1.5","1200","10890","1200","0","1972","226000"
"2","1","1030","9192","1030","0","1959","225000"
"4","2","1540","7575","1040","500","1978","215000"
"3","1","1520","8600","1040","480","1951","210000"
"3","1.5","1920","61014","1920","0","1953","210000"
"2","1","700","7303","700","0","1953","209995"
"2","2","890","5000","890","0","1917","207950"
"2","1","740","6460","740","0","1953","178500"
"3","1","1030","6600","1030","0","1954","175000"
"4","3.75","4520","9240","3270","1250","1992","1250000"
"4","2.5","2610","3277","1920","690","1922","1000000"
"4","2.5","3500","10891","3500","0","1995","917000"
"4","3.5","3600","5697","2940","660","2014","870515"
"2","1.75","1900","13122","1100","800","1954","869000"
"6","3.75","3160","5000","3160","0","1989","848750"
"4","2.5","2380","12573","2380","0","1963","835100"
"4","2.5","2910","6555","2910","0","2005","810000"
"4","3.5","3670","4960","2870","800","2005","796000"
"4","2","1510","3500","1510","0","1911","791500"
"4","2.5","2270","13449","1310","960","1975","780000"
"4","1","3390","4500","2190","1200","1924","780000"
"5","1.75","2440","175421","1740","700","1944","765000"
"2","1","1410","3600","1310","100","1925","760000"
"3","2.25","3270","168000","3270","0","1982","750000"
"5","3.5","2720","11454","1830","890","1988","740000"
"4","2.5","3550","35689","3550","0","1991","730000"
"4","2.5","2990","29170","2990","0","1999","725000"
"3","2.5","2190","7982","2190","0","2004","700000"
"3","2.5","2580","8154","2090","490","1956","699000"
"4","3.25","3730","11820","2460","1270","1990","690000"
"4","2.5","2660","40312","2660","0","1977","667400"
"3","2.5","2510","3819","2510","0","2007","667000"
"3","1.75","2070","5500","1130","940","1946","645000"
"3","2.5","2390","8315","2390","0","1990","640000"
"4","2.5","2210","9875","2210","0","1990","639000"
"3","1.75","4000","11894","2190","1810","1987","628000"
"5","1","3240","5324","3240","0","2007","625000"
"3","2.25","2190","45738","2190","0","1990","620000"
"3","3.25","1470","1152","1470","0","2003","615000"
"5","2.75","2930","31411","1520","1410","1975","610000"
"3","2.25","2300","12430","1580","720","1960","590000"
"4","2.25","2580","7344","2580","0","1977","588000"
"3","1.75","1740","9500","1150","590","1958","585000"
"3","1.75","1930","213008","1300","630","1980","568000"
"4","2.5","2600","9935","2600","0","2005","540000"
"4","2.5","2810","4500","2810","0","2014","518380"
"6","4.5","3300","7561","3300","0","1980","510000"
"6","4.5","3300","7480","3300","0","1980","510000"
"3","3","1560","2250","1560","0","2009","503045"
"3","1.5","2240","13288","2240","0","1953","495000"
"3","1.75","1770","10125","1770","0","1944","487000"
"3","2.75","2290","14810","1400","890","1967","481000"
"3","2","1580","7400","1050","530","1977","480000"
"3","2.5","2630","185130","2630","0","1991","475000"
"4","2.5","1850","11250","1210","640","1981","470000"
"5","3.25","3910","7077","2710","1200","2000","470000"
"2","2","1480","804","1480","0","2008","459000"
"3","2","2270","148975","1270","1000","1900","452000"
"5","3","2260","6508","1330","930","2003","451000"
"3","2.5","2320","15024","2320","0","1990","447500"
"3","2","1790","32379","1790","0","2007","440000"
"3","2.75","1830","6460","1830","0","1991","434000"
"3","1.75","1380","8182","1380","0","1942","425000"
"4","2","2280","10319","1270","1010","1989","420000"
"4","1.5","1850","6125","1110","740","1945","399950"
"2","2","1340","6947","1340","0","2007","389000"
"3","1","920","3532","920","0","1910","380000"
"3","1.75","1750","10870","1750","0","1968","380000"
"2","2.5","1400","2958","1400","0","2007","372500"
"2","1","980","5110","780","200","1939","365000"
"3","1.75","1300","7770","1300","0","1967","360000"
"2","2.5","1278","987","1002","276","2007","358000"
"3","2","1690","10062","940","750","1928","356200"
"3","2.5","2100","3574","1690","410","2005","350000"
"2","2.5","1280","940","1060","220","2006","350000"
"4","2.5","2280","4096","2280","0","2003","349000"
"3","1","1320","11457","1320","0","1959","339950"
"4","2.5","2610","5240","2610","0","2004","337000"
"4","1","1780","4310","1780","0","1919","336000"
"2","2","1380","5840","1380","0","1988","335000"
"3","2.25","2060","47318","1600","460","1976","335000"
"4","2.5","2229","5723","2229","0","2012","324950"
"4","2.5","2038","7643","2038","0","2011","319950"
"4","2.5","2100","169448","2100","0","1998","305000"
"2","1","1095","5120","1095","0","1901","302282"
"3","1","1110","7000","1110","0","1955","302000"
"2","1","1070","189486","1070","0","1942","299000"
"3","2.5","1852","4000","1852","0","2014","298000"
"4","2.5","1850","8198","1850","0","1993","295000"
"2","1","850","5250","850","0","1950","294000"
"3","2.25","1310","12825","1310","0","1950","291750"
"3","1.75","1690","3449","1690","0","1987","289000"
"3","1.5","1200","8040","1200","0","1959","279500"
"3","1","1320","5750","1320","0","1913","279000"
"4","2","1560","7569","1560","0","1966","279000"
"3","1","1000","8018","1000","0","1969","275000"
"4","2.25","2115","6234","2115","0","1998","272000"
"3","2","1660","8641","1660","0","1987","269950"
"3","1.75","1760","12823","1460","300","1956","269950"
"3","2.5","1780","6527","1780","0","1989","265000"
"3","1.75","2200","7200","1270","930","1962","265000"
"3","2","1390","7200","1390","0","1996","258000"
"4","1.5","1360","9323","1360","0","1968","257500"
"4","2.75","1760","9222","1140","620","1971","255000"
"3","1","1250","7920","1250","0","1960","250000"
"4","2.25","1500","5393","1500","0","1999","215000"
"4","1.75","1610","9652","1610","0","1969","215000"
"3","1.75","1570","15570","1570","0","1981","209950"
"4","1","1630","8400","1630","0","1962","209950"
"3","2.25","2070","11576","2070","0","1974","196000"
"2","1","1000","4179","1000","0","1914","189900"
"3","2.5","1730","1803","1730","0","2005","187000"
"2","1.5","1360","1934","1360","0","1978","150000"
"3","1","840","9480","840","0","1960","86500"
"4","2.25","3920","7200","3120","800","1928","1480000"
"3","3.25","3786","38038","1934","1852","1978","1380000"
"4","3","4120","14021","4120","0","2005","1300000"
"4","3.25","3740","11467","3740","0","2014","1140000"
"4","3","2290","2350","1610","680","1924","991700"
"4","2.5","2580","3943","2580","0","2013","899000"
"4","2.75","3080","7242","3080","0","2014","889950"
"4","3.5","4210","9414","4210","0","2001","884744"
"4","2.75","3020","7203","3020","0","2014","879950"
"4","4","3770","9750","1940","1830","1967","872000"
"3","3.75","3830","219106","3830","0","1977","865000"
"4","2","3380","90968","1690","1690","1979","850000"
"4","1","2500","35802","2500","0","1955","850000"
"4","3","4480","42717","4480","0","1987","835000"
"2","2.5","2210","4440","1440","770","1931","820000"
"4","2","2530","15520","2220","310","1964","813500"
"3","2","1840","6000","1720","120","1946","778000"
"5","2.75","3360","12080","3360","0","2014","769995"
"5","2.75","3010","5398","3010","0","2014","769995"
"5","2.75","3030","13640","3030","0","1980","768000"
"2","2.5","2630","7957","2630","0","2003","750000"
"4","2.5","3170","4979","2570","600","1925","748000"
"3","1.75","2180","10221","1140","1040","1946","705000"
"3","2.5","1300","5150","1300","0","1920","690000"
"3","2.5","3450","8000","2970","480","1927","685000"
"4","2.5","2460","4166","2460","0","2003","653750"
"4","2","1410","4480","1410","0","1927","625000"
"4","2.5","2610","5562","2610","0","2013","610360"
"3","2","2420","208652","2420","0","2005","590000"
"2","1","1190","6967","1190","0","1946","587100"
"4","2.5","1860","8117","1460","400","1966","585000"
"3","2.5","2000","7251","2000","0","1995","577500"
"3","2.25","2680","100188","1580","1100","1978","575000"
"3","3","3290","80471","2330","960","1975","562000"
"3","2.5","1630","1587","1630","0","2004","557000"
"3","2.25","2700","4025","1760","940","1907","552500"
"4","1.5","1470","5040","1470","0","1946","551000"
"3","2","1420","1369","1340","80","2007","550000"
"4","3.5","3906","9674","3906","0","2014","549950"
"2","1","1470","3864","1170","300","1916","548000"
"4","2.75","3410","35040","3410","0","1984","545000"
"2","3.5","2560","5000","1280","1280","1944","535000"
"4","2.5","2370","9601","1570","800","1976","530000"
"6","4.5","3300","7200","3300","0","1980","510000"
"3","2.25","1580","4379","1580","0","1994","500000"
"4","2.5","2510","4349","2510","0","2010","490000"
"4","2.5","2420","10603","1210","1210","1958","485000"
"3","2.5","1640","7847","1640","0","1987","480000"
"3","2.5","2150","4084","2150","0","2007","465000"
"4","3","2480","9238","2050","430","1913","455000"
"4","2.5","2090","4400","2090","0","2011","455000"
"3","2.25","1760","10013","1760","0","1983","450000"
"3","2.5","1530","3840","1530","0","1994","449950"
"3","2.75","2070","9697","1330","740","1929","440000"
"3","2.5","1540","7773","1540","0","1982","439950"
"4","2.5","2440","5350","2440","0","2003","435000"
"3","1","1230","6000","780","450","1937","433500"
"6","3","2630","8800","1610","1020","1959","430000"
"3","2","1540","8011","1540","0","1988","425000"
"5","2.75","1340","11583","1190","150","1962","425000"
"3","1","1280","3200","1280","0","1903","425000"
"4","2.75","2950","49658","2950","0","1960","424900"
"2","1.75","1060","4182","1060","0","1977","420000"
"4","2.5","2030","8100","1150","880","1973","420000"
"3","1.75","1470","4000","1070","400","1979","415000"
"3","1.75","1490","9844","1190","300","1959","411000"
"3","2.25","1790","5794","1380","410","1985","410000"
"3","2.5","1090","7700","1090","0","1957","394950"
"3","2","1160","3441","580","580","1930","394000"
"2","1","890","5423","890","0","1946","391000"
"4","2.5","1840","15496","1840","0","1991","390000"
"4","2.5","1890","6947","1890","0","1968","389999"
"3","2.25","1830","25641","1830","0","1989","379500"
"5","2.5","2840","15598","1470","1370","1975","375000"
"3","1.5","1110","5500","1110","0","1940","375000"
"3","1","940","8512","940","0","1967","355000"
"3","1","1130","8201","1130","0","1948","350000"
"2","1","1060","3325","770","290","1932","344000"
"3","2.5","1470","3976","1470","0","1999","337000"
"3","1.75","1400","7920","1400","0","1965","335000"
"3","2.5","2330","12040","1480","850","1980","325000"
"3","2","1540","10931","1540","0","1989","324000"
"3","2.5","1990","3600","1990","0","2004","310000"
"2","1","1560","4920","780","780","1947","310000"
"3","2.5","2140","9492","2140","0","1994","302000"
"3","2.25","1940","9100","1630","310","1966","299000"
"4","2.25","1830","5720","1830","0","2003","295000"
"3","2.25","1670","7150","1670","0","1990","282500"
"3","2.5","1760","7601","1760","0","1992","281000"
"2","1","2280","37500","2280","0","1932","280000"
"2","1","1280","5728","1280","0","1941","272925"
"3","2.5","1790","6371","1790","0","1998","272000"
"2","1","1210","17389","1210","0","1948","259000"
"3","1","880","5375","880","0","1924","256000"
"3","1.5","2030","14400","1310","720","1969","250000"
"4","2.25","1860","9576","1400","460","1962","249000"
"3","1.75","1260","7362","1260","0","1984","240000"
"4","1","1460","6000","730","730","1941","239950"
"2","1","1430","4000","930","500","1949","230000"
"4","2","1440","7950","1440","0","1962","225500"
"4","2.5","2260","9686","1520","740","1965","224950"
"4","2","1200","8470","1200","0","1961","223000"
"3","1.75","1430","13399","900","530","1946","215000"
"2","1.75","1240","2493","1240","0","1985","188500"
"4","1.75","1920","7500","1920","0","1962","170000"
"4","1","1000","7134","1000","0","1943","165000"
"2","1.5","1050","3419","1050","0","1996","163500"
"6","4","3020","13237","2840","180","1942","1900000"
"4","3.75","4490","7623","3090","1400","1941","1720000"
"4","3.25","4030","36762","4030","0","1988","985000"
"4","2.5","3090","10730","2420","670","1985","974350"
"4","3.25","3830","6765","3830","0","2014","963990"
"4","2.5","3520","12193","3520","0","1993","905000"
"4","2.75","3555","6565","3555","0","2014","895990"
"2","2.5","3360","6750","3360","0","2004","850000"
"3","3.5","3460","15745","3460","0","1986","845000"
"4","2.5","2940","7675","2940","0","2004","845000"
"5","4","3600","14720","1800","1800","1960","835000"
"4","2.25","2770","9340","2770","0","1979","825000"
"3","3","3730","35900","2960","770","1979","825000"
"4","3.25","3500","10260","3500","0","1987","798000"
"4","2.75","2640","9000","2640","0","1990","790000"
"4","2.75","3540","7091","1970","1570","1947","784000"
"3","2.75","1970","2600","1970","0","1924","780000"
"4","2.5","2070","8473","1250","820","1976","775000"
"4","2.5","3000","5639","3000","0","2008","759900"
"4","2.5","3300","28433","3300","0","1998","725000"
"3","2.5","2270","7866","2270","0","1988","716000"
"5","2.5","2670","14455","2670","0","1958","685000"
"4","2.5","2740","10533","2740","0","1997","672800"
"4","2.5","2440","10049","2440","0","1989","672000"
"4","2.5","2240","7540","1540","700","1962","654000"
"4","2.75","2020","15810","1620","400","1967","650000"
"4","2.75","2290","3060","1550","740","1928","620000"
"4","2.5","2410","15899","2410","0","1990","610000"
"4","1.75","1950","4200","1040","910","1951","601000"
"4","2.75","3210","6825","1810","1400","1975","580000"
"4","2.25","2150","9520","2150","0","1979","573000"
"3","1","940","1948","940","0","1900","551000"
"2","2","1980","6000","1220","760","1906","549000"
"4","2.5","1980","4500","1980","0","1989","545800"
"3","1","1610","5100","1010","600","1901","535610"
"3","1","1370","4040","1370","0","1906","530000"
"2","2.5","1320","1395","990","330","2014","529000"
"3","2.5","1710","3469","1710","0","1999","524250"
"4","2","2000","6380","1860","140","1949","520000"
"5","2.75","2710","4136","2710","0","2014","515805"
"3","2.25","1360","1236","1140","220","2006","500000"
"3","1","1440","5580","1440","0","1908","499950"
"4","3","2180","12196","2180","0","1968","499900"
"4","2.75","2790","7803","2790","0","2013","485000"
"4","2.75","2790","5000","2790","0","2014","484259"
"4","2.5","2680","8062","1530","1150","1967","470000"
"3","2.5","1990","12866","1990","0","1986","450000"
"4","1.75","1730","5922","1730","0","1949","446000"
"4","2.5","1450","3600","1250","200","1902","431000"
"4","1.75","2120","15920","1060","1060","1960","425000"
"3","1.75","2140","15030","1570","570","1958","419000"
"5","2.75","2060","8906","1220","840","1978","415000"
"3","2.5","1740","4948","1740","0","2008","410000"
"2","1.5","1180","1034","1120","60","2001","410000"
"2","1","990","3000","990","0","1918","409950"
"4","2.5","2050","14724","2050","0","1989","398000"
"3","2.5","2130","5088","1840","290","2011","395000"
"3","2.25","2950","8036","1950","1000","1963","386500"
"5","2.75","3000","25175","1500","1500","1961","379000"
"3","1","1870","7671","1720","150","1937","375000"
"3","1","1610","11250","1090","520","1975","375000"
"3","2.75","1890","3930","1890","0","1999","375000"
"3","1","810","7000","810","0","1968","367000"
"2","1","710","4000","710","0","1909","362362"
"3","1.75","1260","11775","1260","0","1942","353000"
"3","2.5","2040","4348","2040","0","2006","346950"
"3","1.75","1150","13278","1150","0","1966","339000"
"2","1.75","1000","5100","940","60","1906","335000"
"2","1","1440","8842","840","600","1950","335000"
"3","3","2031","7702","2031","0","1988","335000"
"3","1.75","1730","15003","1150","580","1980","335000"
"3","2","2170","3978","1340","830","1919","330000"
"3","1.75","1810","8048","1290","520","1983","325000"
"4","2.5","1820","6916","1820","0","1994","318400"
"3","2.5","1660","10763","1660","0","1994","315000"
"2","1.75","1160","8625","1160","0","1941","312000"
"3","1.75","1400","10350","1400","0","1976","305000"
"3","1","830","3386","830","0","1942","295000"
"2","2.5","1380","889","1140","240","2012","294000"
"4","2.5","1770","5000","1770","0","2004","291500"
"2","1.5","770","850","770","0","2006","290000"
"3","1","1220","6600","1220","0","1958","286700"
"3","2.5","1440","3800","1440","0","2005","269000"
"3","2","1239","6036","1239","0","2009","253101"
"4","1.75","2290","7765","2290","0","1936","247500"
"3","1","1300","14000","1300","0","1958","230000"
"2","1","1060","6100","1060","0","1951","228000"
"3","2.25","1470","6808","1160","310","1984","225000"
"3","1.5","1220","8345","1220","0","1931","225000"
"2","1","990","6448","990","0","1948","219950"
"3","1.75","1580","9705","1580","0","1977","216000"
"3","2.25","1630","9145","1630","0","1960","203000"
"3","1","1360","20000","1360","0","1953","159000"
"2","1","850","54000","850","0","1950","150000"
"3","4.25","5150","7800","4170","980","1954","2250000"
"3","3","3620","28064","2370","1250","1977","2230000"
"4","3.5","4065","18713","4065","0","1987","1950000"
"4","2.5","3910","22710","3910","0","1908","1750000"
"5","4","4590","35046","4590","0","2008","1720000"
"3","2.75","2680","20104","1820","860","1964","1320000"
"4","1.75","4060","5500","2660","1400","1924","1300000"
"3","2.5","3350","7752","2180","1170","2009","1300000"
"4","3.5","4670","6000","3820","850","2007","1240000"
"3","2.25","2390","7875","1980","410","1948","1190000"
"4","2.5","3420","6233","3420","0","2006","890900"
"3","2","2350","6000","1990","360","1922","875000"
"3","2.5","3140","10983","3140","0","1991","810000"
"3","2.25","2370","10289","1590","780","1977","790000"
"3","2.25","2130","11782","1590","540","1977","780000"
"3","2.25","3330","15258","3330","0","1986","762500"
"5","3","2230","8560","1150","1080","1960","750000"
"3","1.75","2040","11294","1340","700","1952","730000"
"4","2.5","2370","10000","1660","710","1974","715000"
"3","1","1570","4000","1570","0","1908","700000"
"3","2.5","2640","5964","2640","0","2003","678000"
"3","2.5","2550","4954","1850","700","1924","675000"
"3","2.5","1920","3624","1920","0","2003","674000"
"4","2.25","2130","8410","2130","0","1977","671500"
"5","2","1900","5470","1180","720","1930","667000"
"3","2.5","3136","54450","3136","0","1910","665000"
"3","2.5","2070","49658","1540","530","1980","653450"
"4","1.75","2390","12000","1470","920","1979","650000"
"4","2.5","2490","40608","2490","0","1997","635000"
"3","2","1510","4560","1510","0","1909","629000"
"3","1.5","1990","5978","1990","0","1926","625000"
"4","2.5","2310","9624","2310","0","1984","597750"
"3","3.25","3130","28001","2210","920","1985","595000"
"2","2","1870","5562","1870","0","2006","592500"
"4","2.75","2160","4205","1080","1080","1969","590000"
"4","2.75","2200","9453","1100","1100","1955","583000"
"5","2.25","2100","6936","1600","500","1974","567000"
"4","3","2170","5764","2170","0","1992","560000"
"4","2.5","2050","8683","2050","0","1987","550000"
"3","2.5","2340","4200","1540","800","1906","550000"
"3","1","1120","6600","1120","0","1943","549995"
"2","1","1120","7500","1120","0","1971","540000"
"4","1.5","2993","19400","2233","760","1921","540000"
"3","1.75","1630","15600","1630","0","1958","522000"
"4","2.25","2640","34870","1770","870","1977","518000"
"3","1.5","2150","4000","1470","680","1928","500000"
"3","2.25","1420","983","1420","0","2006","500000"
"4","2.75","2100","7236","1400","700","1979","491500"
"3","2","2260","7163","2260","0","2012","479950"
"3","2.25","1890","12236","1890","0","1978","473000"
"3","3.5","3520","35512","2760","760","2005","470000"
"4","1.75","2250","8580","1330","920","1958","468000"
"3","2.25","1630","2490","1630","0","2004","468000"
"4","2.5","2200","6400","2200","0","2010","460000"
"3","1","1290","3880","1290","0","1919","456500"
"3","2.25","2180","6850","1750","430","1973","455000"
"3","2.5","1420","814","1140","280","2008","451300"
"3","2","1620","5101","590","1030","2006","445000"
"5","1.75","1360","10609","1060","300","1966","431200"
"3","1.5","1580","5000","1290","290","1939","430000"
"2","1","990","4920","990","0","1931","430000"
"4","1","1350","9000","1350","0","1964","430000"
"3","2.5","1430","9240","1430","0","1984","429000"
"4","2","2180","10447","1280","900","1969","419000"
"2","2","1350","3926","1350","0","2007","410000"
"5","2.75","2910","5802","2910","0","2006","410000"
"3","2.25","2070","14196","2070","0","1989","379500"
"5","2","1600","4168","1600","0","1927","365000"
"5","1.75","1550","5225","1550","0","1941","360000"
"4","2.5","2610","5866","2610","0","2005","350000"
"4","2.5","2770","9751","2770","0","1989","347000"
"4","2.5","1983","6002","1983","0","2012","345000"
"2","1","1090","6771","1090","0","1954","340000"
"4","2.25","2230","6791","2230","0","2005","340000"
"3","2.5","2270","7917","2270","0","1986","340000"
"4","2.75","2110","6838","2110","0","1991","325000"
"3","1","1240","7500","1240","0","1976","324950"
"4","1.5","1890","10707","1890","0","1962","319990"
"3","2","1790","8228","1390","400","1980","317000"
"3","1","1640","12060","1640","0","1960","311000"
"4","1.75","1480","11200","1480","0","1969","310000"
"3","1","1060","9241","1060","0","1956","301000"
"3","1.75","1730","14270","1730","0","1959","299000"
"4","2.75","2390","7330","2390","0","1989","282000"
"4","2.25","1834","7460","1834","0","2012","280000"
"3","2.5","2497","4400","2497","0","2007","275000"
"4","1","1080","26114","1080","0","1900","275000"
"3","1.5","1390","2153","1390","0","2001","267500"
"3","2.5","1670","5797","1670","0","1988","260000"
"3","2","1170","5450","1170","0","1902","260000"
"3","2.5","1489","3266","1489","0","2014","255900"
"3","1","1190","6250","990","200","1954","250000"
"3","1","1750","8820","1750","0","1961","234000"
"5","1","1410","9000","1410","0","1967","230000"
"3","1.5","1370","9000","1370","0","1962","225000"
"4","2.5","1847","8000","1847","0","2008","215000"
"3","2.25","1560","6013","1560","0","1990","213675"
"3","1","870","5200","870","0","1969","183000"
"3","1","1250","5411","1250","0","1980","164808"
"2","1","700","13500","700","0","1920","152000"
"2","1","940","6000","940","0","1943","115000"
"1","1","1080","3230","1080","0","1963","112000"
"4","1.75","2700","7625","1450","1250","1937","710000"
"4","2.25","2130","10650","2130","0","1977","686000"
"2","1","1410","5101","1410","0","1927","658500"
"3","1","1020","5410","880","140","1928","505000"
"3","3.25","1210","941","1000","210","2002","350000"
"2","1.75","1000","3554","1000","0","1975","210000"
"2","1","900","4397","900","0","1918","205000"
"3","1","910","8700","910","0","1943","165000"
"2","1.5","1220","1036","1220","0","2006","286308"
"4","3.5","5860","7200","3690","2170","1907","2400000"
"3","3.5","4070","26000","4070","0","1991","1480000"
"5","3.5","4800","14984","3480","1320","1998","1350000"
"3","2.75","2380","5572","1930","450","1939","1160000"
"4","2.5","3840","16619","3840","0","1983","1120000"
"4","2.75","3010","10830","3010","0","1980","1090000"
"4","2.5","2750","9949","2750","0","1999","1050000"
"3","2.5","2920","5629","1460","1460","1955","1020000"
"4","4.5","3890","5906","3060","830","2004","970000"
"4","3.5","4120","7304","3070","1050","2006","968933"
"3","1.75","2150","3503","1870","280","1921","950000"
"3","3.25","2610","4500","1660","950","1909","925000"
"3","2.25","3650","5353","2200","1450","1947","920000"
"5","3","3900","5250","2620","1280","1931","850000"
"4","2.5","3090","7112","3090","0","2001","775000"
"3","2.5","3370","36218","3370","0","1988","699950"
"4","2.5","2120","8448","2120","0","1989","690000"
"3","1","1580","4000","1580","0","1905","690000"
"5","2.75","3320","10500","2020","1300","1963","687500"
"4","2","2970","52567","2970","0","1924","665000"
"3","3","2260","1834","1660","600","2002","651000"
"3","1.75","1550","5000","1250","300","1911","650000"
"4","2.5","2240","4025","1250","990","1926","630000"
"4","1.75","1770","12278","1350","420","1937","630000"
"5","3.25","3570","5425","3570","0","2005","627000"
"4","2.5","1750","9000","1410","340","1977","625000"
"3","2.5","1990","8325","1310","680","1997","590000"
"3","1","1530","2370","1530","0","1901","590000"
"5","2.75","2350","4178","1520","830","1922","585000"
"3","1.75","1480","4800","1140","340","1944","585000"
"3","2.5","2480","6600","2480","0","2002","583800"
"3","2.5","2360","9938","1690","670","1987","572000"
"2","1","960","4080","960","0","1911","565000"
"3","1.75","1720","2218","1270","450","1931","565000"
"3","3","2410","12183","2410","0","1988","555000"
"4","2","1990","29078","1990","0","1984","540000"
"4","2.75","2710","45963","2710","0","1995","535000"
"2","1","1170","3000","1170","0","1910","527500"
"2","2","1450","2272","750","700","1924","524000"
"4","1.75","1640","9299","870","770","1943","522500"
"5","2.75","3050","7500","1800","1250","1966","517850"
"4","2.25","1490","956","1020","470","2005","507000"
"3","1.5","1620","5108","1620","0","1954","499100"
"2","1","770","11250","770","0","1918","497000"
"4","2.5","2740","33158","2740","0","1993","476000"
"2","1.75","1530","7020","1030","500","1942","469775"
"3","1.5","1200","890","1030","170","2008","464950"
"4","3.5","3217","4000","2587","630","2008","458000"
"3","2.5","1690","4584","1690","0","2002","455800"
"6","2.25","2660","13579","2660","0","1937","452000"
"6","2.5","2800","10490","1400","1400","1968","442500"
"3","2.5","1840","5680","1840","0","2008","435000"
"4","2.25","2060","8540","1540","520","1967","425000"
"3","2.5","2200","34680","2200","0","1985","424000"
"3","1.75","1720","4160","860","860","1940","420000"
"2","2.5","1590","2088","1590","0","1997","411000"
"3","2","1810","10860","1810","0","1967","407450"
"3","1.75","1790","6980","1330","460","1980","402200"
"4","2.5","2710","8127","2710","0","1994","399900"
"3","3.25","2760","6420","2110","650","1991","375000"
"4","1.75","1690","10854","1690","0","1977","371000"
"4","2.5","2210","17715","2210","0","1997","360000"
"3","3.25","1710","2171","1400","310","2014","358990"
"3","1.75","1830","10954","1830","0","1963","346950"
"5","3","3070","5252","3070","0","2005","341950"
"4","2.5","2380","9362","2380","0","2000","340000"
"2","1","700","4350","700","0","1943","328000"
"3","1.75","1830","12500","1200","630","1947","323000"
"2","1","960","1716","960","0","1951","319000"
"3","2.5","1600","7982","1600","0","1993","315000"
"3","2","2440","13250","1440","1000","1977","312000"
"3","1","1300","9000","1300","0","1956","305240"
"4","2.5","2250","9091","1340","910","1982","305000"
"4","2.5","2810","6146","2810","0","1998","301000"
"3","2","720","7598","720","0","1947","300000"
"3","2.5","1590","3121","1590","0","1994","299000"
"3","2","2420","8800","1420","1000","1959","298500"
"4","1.75","2510","7440","1290","1220","1962","285000"
"3","1.75","1930","7200","1930","0","1929","285000"
"4","2.5","2060","5742","2060","0","1999","275000"
"3","2.5","1870","6821","1870","0","1989","275000"
"4","2.75","1830","3420","1830","0","2012","269800"
"4","1","1370","41194","1370","0","1900","255500"
"3","2.5","1530","2890","1530","0","2001","250000"
"3","1","1460","10914","1460","0","1959","250000"
"3","2","1520","7131","1520","0","1993","241000"
"3","0.75","1040","15000","1040","0","1941","230000"
"3","2","1090","7350","1090","0","1990","219000"
"3","1","1180","7669","1180","0","1967","215000"
"3","1","1180","9000","1180","0","1970","215000"
"3","1","840","8400","840","0","1959","187500"
"4","1.5","1500","2106","1500","0","2014","182568"
"3","2.25","1960","8875","1290","670","1965","182000"
"3","1.5","1280","5547","1280","0","1985","167000"
"5","5.25","5090","23669","5090","0","2006","3100000"
"4","2.5","5760","32033","4390","1370","1994","2880000"
"4","5.25","5240","320917","5240","0","2006","1860000"
"4","2.25","3960","8640","2630","1330","1925","1400000"
"3","3.75","6400","76665","3810","2590","1966","1330000"
"4","3.25","3470","11843","2270","1200","1989","1320000"
"4","2.25","3310","8540","1660","1650","1973","1100000"
"4","2","1780","15648","1780","0","1918","1000000"
"3","2.25","3200","3800","2650","550","1914","995000"
"4","2.5","3160","39960","3160","0","1980","940000"
"4","3","2900","10400","1530","1370","1959","930000"
"3","3.25","3660","9496","3660","0","2003","920000"
"4","1.75","1800","4180","1800","0","1921","865000"
"3","3","2960","42159","2960","0","1995","849000"
"4","2.75","3130","21810","3130","0","1993","840000"
"4","2.5","2920","252648","2920","0","2002","820000"
"4","1.5","2060","16110","2060","0","1949","815000"
"4","2.5","2930","5000","2760","170","2007","800000"
"4","2.5","3400","6742","3400","0","2004","799000"
"4","2.5","3230","21781","3230","0","1993","785000"
"4","2.5","3080","4553","3080","0","2008","750000"
"4","1.75","2520","21834","1420","1100","1960","750000"
"3","2.5","2960","69351","2960","0","1990","750000"
"4","3.5","3760","57063","2950","810","1998","740000"
"3","2.5","2060","8778","1160","900","1953","731100"
"3","1.5","1980","4000","1980","0","1919","707000"
"3","1.75","1620","5500","1110","510","1950","680000"
"5","2.25","2540","3750","1510","1030","1925","660000"
"4","2","2670","3240","1780","890","1930","630000"
"4","2.25","2100","8290","2100","0","1978","625000"
"3","2","2660","4500","1330","1330","1922","605000"
"4","2.25","2510","31584","2510","0","1979","605000"
"4","2.75","2810","17674","1640","1170","1978","600000"
"4","2","3090","87120","1590","1500","1974","595000"
"4","2.5","2910","7287","2910","0","1998","595000"
"3","2.5","2110","3870","2110","0","2004","590000"
"4","2.75","2330","6703","1710","620","1983","580000"
"4","3.5","3930","16970","3930","0","1997","575000"
"3","2.5","3240","33661","3240","0","2001","575000"
"5","2.5","2880","9000","1440","1440","1966","560000"
"4","2.5","2650","7200","2250","400","1979","559950"
"4","2.25","2420","5040","1350","1070","1985","549000"
"4","1.75","1910","6731","1210","700","1953","545000"
"3","2.5","1540","1256","1540","0","2004","543000"
"3","2.5","2500","4203","2500","0","2001","539900"
"3","2","2740","23505","2740","0","1988","535000"
"3","2.5","1970","6295","1970","0","2011","530000"
"3","1.75","1570","10939","1200","370","1974","515000"
"4","2.5","2600","4506","2600","0","2005","512000"
"2","2.5","1900","4871","1900","0","2005","504975"
"2","2","1250","3360","1250","0","1957","500000"
"4","2.5","2810","6296","2810","0","2013","487500"
"5","1.75","2140","43124","1220","920","1962","485000"
"5","1.75","2840","10220","2210","630","1954","462000"
"4","1","1260","8505","1260","0","1951","461000"
"3","2.5","2050","5694","2050","0","2004","457000"
"3","2","1720","15000","1720","0","2011","441000"
"3","2.25","1880","7989","1280","600","1982","440000"
"4","2.5","3220","8256","2610","610","2006","440000"
"3","2.5","1778","147823","1778","0","1999","435000"
"4","2.5","3172","5033","3172","0","2014","432500"
"4","2.5","2320","4254","2320","0","2004","423000"
"4","2.5","2750","5767","2750","0","2005","419900"
"3","1","1020","6903","1020","0","1951","410000"
"2","1.75","1480","4000","740","740","1925","409000"
"3","2.5","1690","1609","1150","540","2014","404763"
"5","2.5","2510","7525","1710","800","1929","400000"
"3","2","1630","7800","1630","0","1950","376500"
"3","1.75","1740","8424","1040","700","1954","364500"
"2","1","780","4200","780","0","1920","360000"
"3","1.75","1720","8867","1320","400","1985","348000"
"4","2.75","2690","8451","2690","0","1998","346290"
"3","2.5","1360","1489","1360","0","2007","345000"
"3","2.25","1750","8900","1750","0","1977","341000"
"4","2","1590","8779","1590","0","2001","337000"
"3","1","1380","7470","1380","0","1965","335000"
"2","1","880","12000","880","0","1939","334550"
"3","1.75","1660","10000","1660","0","1972","331292"
"4","1.75","1990","7194","1400","590","1978","328000"
"4","2.5","2230","8500","2230","0","1994","325000"
"3","1.75","2300","12000","1770","530","1942","320000"
"2","1","1010","7338","1010","0","1981","315000"
"3","2.5","1260","2767","1260","0","1999","315000"
"2","2.5","1860","1716","1860","0","2003","314950"
"3","1.75","1560","82328","1560","0","1974","310000"
"3","1","1280","9656","920","360","1959","309000"
"3","2","1600","13200","1600","0","1990","308550"
"3","2","1160","7217","1160","0","1969","306000"
"4","2.5","2230","5000","2230","0","2003","305000"
"3","2.5","1260","1622","1260","0","2009","305000"
"4","2.5","2320","4683","2320","0","2007","305000"
"5","2.5","2093","10350","2093","0","1963","300000"
"3","2","1810","10530","1810","0","1991","295000"
"4","2","1760","8100","780","980","1925","285000"
"3","2.25","2080","2050","1550","530","2003","284000"
"4","2.75","2230","10160","1400","830","1968","280000"
"4","2.5","1850","5880","1850","0","1998","277000"
"3","2.25","1640","6044","1640","0","1996","275000"
"3","2.5","2217","8019","2217","0","2009","275000"
"3","1.75","1650","7807","1650","0","1986","267500"
"3","2","1260","1125","810","450","2011","249000"
"3","1","980","7560","980","0","1951","237502"
"3","1.75","2380","12681","1380","1000","1918","227000"
"5","1.75","2340","9148","2340","0","1957","210000"
"3","1.75","1070","7200","1070","0","1994","208000"
"4","2","2200","13320","1100","1100","1944","205000"
"3","2","1290","5757","1290","0","1994","200000"
"3","1","1070","6440","1070","0","1971","194000"
"4","1.75","1790","7175","1410","380","1900","179000"
"3","1","1200","7210","1200","0","1977","168000"
"3","1","902","10464","902","0","1965","152000"
"3","1","1090","10114","1090","0","1955","140000"
"5","4.75","3940","7067","3230","710","2008","1700000"
"4","3.5","3230","7200","1640","1590","2000","1390000"
"4","3.5","4080","14450","3210","870","1998","1290000"
"4","4","4390","17832","2430","1960","1994","1280000"
"4","2.75","3020","8622","3020","0","1976","1190000"
"3","3.5","3380","3333","2800","580","2008","1190000"
"4","2.5","3860","10361","2940","920","1985","1160000"
"4","3.5","4540","19767","4200","340","1998","1150000"
"5","3.5","7350","12231","4750","2600","2001","1110000"
"4","1.75","2600","41041","2600","0","1965","1020000"
"4","2.5","2480","12688","1820","660","1967","1010000"
"3","4","2550","3900","2050","500","1940","990000"
"4","2.5","3240","35083","3240","0","1978","975000"
"3","2.5","2590","21494","2590","0","1991","815000"
"4","2.5","3230","19193","2000","1230","1973","795000"
"2","3","2560","982278","2560","0","2004","790000"
"4","2.5","3140","14421","3140","0","1994","780000"
"5","2","3540","9970","3540","0","1970","775000"
"3","2","1760","5400","1160","600","1927","715000"
"3","1.75","1600","9135","1600","0","1955","625000"
"4","2.25","2530","8736","1210","1320","1958","618000"
"4","2.5","2120","3720","2120","0","2004","615000"
"4","2.5","3010","7953","3010","0","2000","600000"
"4","2.5","2340","7877","2340","0","2004","597000"
"3","1","1560","3960","1560","0","1907","595000"
"4","2.5","2340","8248","2340","0","1989","569500"
"4","1.5","1580","5000","1390","190","1945","535000"
"2","1","980","4120","830","150","1950","535000"
"3","2.25","1210","1250","1210","0","2014","520000"
"2","1.75","1640","3090","910","730","1925","516000"
"2","2.25","1350","1248","1180","170","2000","482000"
"3","2","1510","3750","1510","0","1928","479200"
"3","1.75","1260","10065","1260","0","1954","475000"
"3","2.5","2010","4195","2010","0","1998","463000"
"3","1.5","1570","12196","1570","0","1972","458000"
"5","1.75","1830","47916","1830","0","1948","452000"
"3","1.5","1250","4000","1250","0","1955","452000"
"3","1","1450","3350","1450","0","1919","450000"
"3","1","1370","6001","1230","140","1944","447000"
"3","2.25","1800","11200","1270","530","1979","445000"
"3","1.5","1800","8303","1200","600","1957","442500"
"3","2.5","2340","5171","2340","0","2013","439990"
"3","1.75","1840","7350","1310","530","1976","432100"
"3","1","980","4800","980","0","1926","425000"
"3","1.5","1500","8272","1500","0","1958","419000"
"3","1.5","1750","32500","1750","0","1966","410000"
"4","2.5","2120","215186","2120","0","1983","396400"
"4","3","2090","5102","1350","740","1994","385000"
"3","3.5","1900","4805","1560","340","1999","385000"
"3","2.25","1430","800","1140","290","2011","384000"
"3","1.75","1480","7560","1100","380","1920","375950"
"4","1.75","2190","9225","1250","940","1959","375000"
"3","1","1960","7955","1260","700","1963","375000"
"4","2.5","3200","7282","3200","0","2007","360000"
"3","1.5","1250","7194","1250","0","1969","358000"
"2","1","960","6250","960","0","1916","355000"
"5","3","2080","6150","1040","1040","1950","345000"
"4","2.5","2160","5455","2160","0","2003","340000"
"3","2.5","2170","9798","2170","0","1995","340000"
"3","1.75","1570","7500","1300","270","1953","335000"
"2","2","1440","8425","1440","0","1942","327200"
"3","2","2010","12950","2010","0","1953","310000"
"3","2.25","1960","1585","1750","210","2003","300000"
"3","1.75","1330","10523","1000","330","1981","295500"
"2","1","1170","6543","1170","0","1913","286000"
"3","1","1250","7654","1000","250","1952","275000"
"2","1.75","930","7080","930","0","1923","275000"
"3","2","1540","9253","1540","0","1998","272500"
"4","1.75","1820","13600","1120","700","1959","268500"
"3","2","1380","8536","1380","0","1955","265000"
"3","2","1670","4441","1670","0","2014","256703"
"4","1","1070","7467","1070","0","1944","200000"
"3","1","1040","10080","1040","0","1959","184900"
"1","1","1020","6871","1020","0","1937","152275"
"3","1","1320","24684","1320","0","1979","150000"
"4","2.5","3680","13351","3680","0","1946","1900000"
"4","2.75","3190","14904","1940","1250","1949","1650000"
"5","3.5","3270","4080","2180","1090","2011","1310000"
"4","2.75","3820","8850","3820","0","2014","1270000"
"4","2.5","2880","9003","2880","0","2008","1260000"
"4","2.75","3410","95396","3410","0","1962","1230000"
"4","3.5","4370","18361","4370","0","2001","1150000"
"4","3.75","1980","4095","1980","0","2009","912000"
"5","4.25","4720","18741","3210","1510","2005","875000"
"3","1.75","2450","8603","1340","1110","1940","850000"
"4","2.5","2920","32219","2920","0","1995","795000"
"4","3.5","3080","5250","3080","0","2003","775000"
"3","1.75","1800","5700","1000","800","1941","749950"
"4","2.75","2440","7042","1640","800","1941","725000"
"3","1.75","1880","13300","1380","500","1967","725000"
"4","2.75","2090","8064","2090","0","1967","710000"
"3","2.25","1780","4252","1540","240","1989","675000"
"4","2.5","2860","5576","2860","0","2004","650000"
"2","1","1280","4166","1280","0","1965","650000"
"3","2.5","3410","13809","2450","960","1973","649000"
"3","3","1560","1466","1560","0","2006","640000"
"3","2.5","2910","12283","2910","0","1993","610000"
"3","2.5","2320","5663","2320","0","2003","589000"
"4","2.5","2250","11349","2250","0","1991","572650"
"3","2","1810","12420","1810","0","1957","555700"
"4","2.5","2960","37430","2960","0","1990","539950"
"5","2","2270","8652","1150","1120","1965","513000"
"3","2","1340","2550","1340","0","1984","495000"
"3","2.5","2010","9725","2010","0","1987","490000"
"3","1.5","1870","7853","1300","570","1962","485000"
"3","2.5","1590","1431","1060","530","2010","480000"
"3","3.25","2260","7701","1760","500","2000","477590"
"3","2.25","2220","9800","2220","0","1987","470000"
"3","1.75","1400","12155","1400","0","1977","460000"
"3","2.5","1500","4445","1500","0","1996","457500"
"4","1.75","1980","7350","1430","550","1973","450000"
"3","2.5","1530","762","1050","480","2007","450000"
"4","2","1940","6350","970","970","1951","446000"
"3","1.75","1120","4000","870","250","1916","445000"
"3","2.5","1520","1304","1180","340","2006","438000"
"2","1","1330","5510","850","480","1910","417500"
"3","1","1300","5368","1300","0","1958","415000"
"4","2.5","2050","8909","1690","360","1986","403900"
"3","2","1890","14040","1890","0","1994","395000"
"4","2","1450","5456","1450","0","1951","393000"
"3","3","2480","14141","1500","980","1994","390000"
"3","2","1680","8946","940","740","1996","381000"
"3","2","2010","16736","2010","0","1929","380000"
"3","1.75","2100","9066","1440","660","1962","375000"
"3","2.25","1600","7620","1280","320","1987","370000"
"2","1","820","4880","820","0","1925","363000"
"3","2","1630","10723","1630","0","1959","360000"
"2","2.5","1233","1244","963","270","2007","360000"
"3","2.5","2390","6441","2390","0","2002","349950"
"3","2","1460","5715","1460","0","1957","340000"
"3","2.5","2060","4200","2060","0","2014","326989"
"4","1.75","1950","12500","1330","620","1963","325000"
"3","1","1410","8250","1410","0","1954","325000"
"4","2.75","2475","4276","2475","0","2014","319900"
"5","2.5","2820","9956","1410","1410","1967","318000"
"2","1","730","5040","730","0","1927","316000"
"3","2","1830","10873","1830","0","1989","305000"
"4","2.5","2080","2999","2080","0","1998","300000"
"3","1.75","1420","13187","1420","0","1974","293000"
"6","4.5","2810","11214","2010","800","1958","290000"
"3","2.5","2000","7414","2000","0","1993","290000"
"3","1.75","1660","10440","1040","620","1978","288000"
"3","1.5","1900","9737","1200","700","1968","275000"
"3","2.25","1840","6750","1270","570","1980","265000"
"2","1","820","6771","820","0","1918","260000"
"4","1.5","1520","8800","1520","0","1960","230000"
"3","1.75","1140","1165","1140","0","2014","230000"
"3","1.5","1040","1264","900","140","2015","230000"
"3","2.25","2510","12013","2510","0","1988","225000"
"3","1.5","1480","10588","1480","0","1957","224000"
"3","2","1310","8440","1310","0","1951","223000"
"3","1","1000","12000","1000","0","1959","217000"
"3","1","1010","25277","1010","0","1961","201000"
"3","1.5","1510","6600","1510","0","1938","199950"
"3","1.5","1280","4366","1280","0","1985","183000"
"2","1.5","1560","10807","1560","0","1949","181000"
"3","1","970","4700","720","250","1943","172000"
"2","1","790","7450","790","0","1944","169500"
"4","3","4190","8805","3490","700","1928","2550000"
"4","4","4360","12081","4360","0","2007","1980000"
"5","3.75","4270","7500","3210","1060","2014","1600000"
"3","2","2070","9600","1590","480","1946","1350000"
"5","2.5","2770","8100","2770","0","2002","1310000"
"3","2.5","3420","79279","3420","0","1990","1230000"
"4","2.5","2660","11200","2660","0","1999","1130000"
"4","2.5","2820","5934","1770","1050","1952","960000"
"3","2.5","2979","17313","2979","0","1993","912000"
"4","3.25","2720","4000","2070","650","2014","846000"
"4","2.75","3010","10450","3010","0","1996","810000"
"4","2.75","3110","6050","3110","0","2014","799990"
"4","2.5","3140","7260","2200","940","2004","744000"
"4","2.5","2790","74495","2790","0","1997","725500"
"4","1.75","2190","9400","1450","740","1962","725000"
"2","1.5","1840","9000","1340","500","1957","720000"
"3","3.5","2840","4468","2840","0","2006","717550"
"4","2.75","2780","6207","2780","0","2001","705000"
"5","2.5","3340","24755","3340","0","2002","699000"
"4","2.5","2040","9225","1610","430","1968","675000"
"3","2.25","1520","5750","1400","120","1908","672600"
"4","2.5","2570","9086","2570","0","1999","670000"
"4","1.75","2460","7560","2460","0","1952","635000"
"3","1.75","1850","8823","1370","480","1973","605000"
"3","2.5","2660","10637","2660","0","1991","595000"
"4","2.25","2380","35008","2380","0","1977","594950"
"3","2.75","2550","54014","1980","570","1967","590000"
"4","1.75","2400","21196","1590","810","1956","569000"
"3","3.5","2270","4088","1880","390","1996","560000"
"3","2.25","1580","11680","1580","0","1958","549800"
"5","2.5","1710","9720","1710","0","1974","549000"
"3","1","1870","4984","1120","750","1955","499950"
"4","2.25","2350","10072","2350","0","1980","495000"
"3","1.75","1540","13002","1200","340","1984","492450"
"3","2.5","1670","4308","1670","0","2001","483500"
"4","2.5","1750","11381","1610","140","1947","464500"
"3","1.75","1320","1014","1320","0","2015","455000"
"3","2.5","1510","1618","1330","180","2011","453000"
"4","2","2630","9099","1830","800","1944","445000"
"4","4","4168","8485","3222","946","2007","442000"
"3","2.25","1130","1221","1030","100","2004","437000"
"3","3","1440","4670","1440","0","2005","435000"
"3","2.25","1740","8491","1240","500","1958","435000"
"2","2","1370","4866","1370","0","2005","431500"
"4","2.5","2100","7920","1400","700","1916","429000"
"3","2.5","1940","7415","1940","0","1965","423800"
"3","1","1100","4184","1100","0","1965","416500"
"4","2.5","1160","16008","1160","0","1989","415000"
"3","2.5","1610","3600","1610","0","2010","415000"
"3","1.75","1530","3200","1530","0","1942","412500"
"3","1.75","2000","7480","1320","680","1972","410000"
"3","2.5","1470","1204","1470","0","2006","408000"
"3","2.25","1590","7267","1100","490","1976","405000"
"4","2.25","1970","15743","1370","600","1962","405000"
"3","2.5","1500","9636","1500","0","1994","405000"
"3","2.5","1500","2314","1500","0","2005","405000"
"4","1.75","2430","5481","1430","1000","1953","402000"
"3","2.5","2120","3742","2120","0","2006","400000"
"4","3.5","3350","9681","2140","1210","1980","400000"
"4","1.5","2040","10726","1380","660","1954","385000"
"4","2.5","2260","5824","2260","0","2011","379000"
"2","1","900","5413","900","0","1947","375000"
"4","2.5","3010","5701","3010","0","2003","359950"
"3","3","1320","1071","1080","240","2003","359000"
"3","1.75","1260","12330","1260","0","1968","354000"
"3","1","860","7030","860","0","1973","350000"
"5","3","2240","19090","1700","540","1968","335500"
"2","1","1080","5000","1080","0","1954","325000"
"4","1.5","1100","11824","1100","0","1954","320000"
"5","2.5","2600","4641","2600","0","2005","316000"
"2","1","1040","169448","1040","0","1950","299000"
"4","1.75","1500","8400","1200","300","1956","289950"
"3","1.75","1770","9000","1090","680","1954","286000"
"2","1","990","2446","990","0","1998","285000"
"3","2.5","3020","5868","3020","0","2003","275000"
"3","1","1370","6000","1370","0","1955","245000"
"3","2","1710","5200","1030","680","1977","230000"
"2","2.5","1100","1737","1100","0","2006","190000"
"3","1.75","1350","7370","1350","0","1912","190000"
"3","1","1100","5734","1100","0","1955","178000"
"3","1.75","1610","7392","1610","0","1964","160000"
"4","3.25","3160","5000","2360","800","1965","1250000"
"3","2.5","1700","7210","1700","0","1966","565000"
"2","1","860","8250","860","0","1940","345000"
"3","2.5","1580","2170","1580","0","2003","247800"
"2","2.5","1000","1092","990","10","2004","163800"
"4","1","1360","5766","1360","0","1951","540000"
"5","5.75","9200","35069","6200","3000","2001","5570000"
"4","2.5","4040","9630","2020","2020","1951","1400000"
"5","3.25","5790","13726","4430","1360","2014","1240000"
"5","2.5","4670","15857","4670","0","1998","1000000"
"4","2.75","3160","37200","2310","850","1939","942000"
"4","2.75","2890","5000","1990","900","1911","898500"
"5","3.25","3480","5414","3480","0","2014","864327"
"4","1.75","2480","11010","1630","850","1966","840000"
"4","3.25","3270","6027","3270","0","2001","835000"
"5","1.5","3360","5225","3360","0","2014","834995"
"5","3.25","3360","6120","3360","0","2014","829995"
"5","3.5","3500","10794","3500","0","1996","815000"
"4","3.5","3660","4903","2760","900","2014","809950"
"4","2.5","3480","6262","3480","0","2003","808000"
"4","2.5","3250","8970","3250","0","1994","791500"
"4","1.75","1580","9382","1080","500","1963","787500"
"5","1","1760","4264","1760","0","1902","780500"
"3","2.5","3010","74390","3010","0","1998","775000"
"3","2.5","2660","10928","1830","830","1988","768000"
"4","2.25","2500","8500","2500","0","1979","760000"
"5","1.75","2850","11860","2850","0","1951","750000"
"4","3.75","3210","7054","3210","0","1985","690000"
"1","2.5","1820","3008","1090","730","1910","680000"
"3","2.25","2920","6300","1710","1210","1956","680000"
"2","1.75","1600","5795","1600","0","1940","672324"
"3","2.25","1650","946","1650","0","2014","619000"
"3","2.5","3580","118047","3240","340","1992","616500"
"4","2.5","3000","8100","3000","0","1992","607500"
"4","2","1820","7626","990","830","1941","605000"
"3","1.5","1800","10050","1800","0","1955","583000"
"4","2.5","2150","5000","2150","0","2001","580000"
"3","2.25","1480","1026","1480","0","2014","580000"
"3","1","1590","5400","1280","310","1948","579000"
"3","2.5","1920","3867","1920","0","2005","571000"
"5","1.75","2510","9750","2510","0","1969","570000"
"3","2.5","2750","35440","2750","0","1994","556000"
"2","1","850","2340","850","0","1922","553500"
"3","2.5","2920","169448","2920","0","1990","550000"
"3","3.5","2500","4270","2500","0","2000","538500"
"4","2.5","2310","5573","2310","0","2003","525000"
"3","1.75","1570","8530","1190","380","1983","500000"
"3","2.5","1940","5660","1940","0","2001","488000"
"3","2.5","1320","1310","1320","0","2006","475000"
"3","2.5","2010","2212","1390","620","2014","472217"
"4","2.5","2350","3800","2350","0","2014","469995"
"3","2.5","2050","4876","2050","0","2005","451000"
"3","2.25","1610","8296","1610","0","1978","450000"
"2","1","1180","10720","1180","0","1955","450000"
"2","1","1330","4140","930","400","1919","443500"
"4","1.5","1360","6110","1010","350","1955","442000"
"4","2.5","2800","28254","2800","0","2001","440000"
"3","2.5","2370","6082","2370","0","2004","435000"
"3","1.75","1430","6818","1430","0","1972","424000"
"3","1.5","2500","6000","1730","770","1941","417000"
"2","1","1460","4200","880","580","1914","415000"
"2","1","1270","7440","910","360","1949","400000"
"3","2","1860","12944","1860","0","2002","400000"
"3","1.75","1850","15170","1850","0","1965","390000"
"3","1","1060","8040","1060","0","1949","385100"
"3","2.25","1650","7800","1260","390","1969","385000"
"3","1.75","1220","1450","620","600","1905","385000"
"3","2.5","1600","2610","1600","0","2005","384500"
"6","2","1900","8057","1170","730","1959","375000"
"3","1","980","7296","980","0","1967","375000"
"4","1.5","1280","7400","1280","0","1958","367400"
"3","1","960","5424","960","0","1916","362500"
"3","1.75","1560","7930","1560","0","1980","360000"
"3","2.5","2060","4200","2060","0","2014","339989"
"3","1.75","2010","9417","1500","510","1967","335000"
"3","1","1030","7620","1030","0","1953","330000"
"3","1.75","1460","9261","1460","0","1985","330000"
"4","2.5","1850","5388","1850","0","2009","328000"
"2","1","1060","5703","1060","0","1946","325000"
"3","1.75","1780","11096","1210","570","1979","325000"
"4","3.25","2800","12040","2800","0","2011","325000"
"3","2.5","2060","4742","2060","0","2014","324747"
"3","1.75","1970","8200","1270","700","1964","315000"
"3","2.5","1820","4200","1820","0","2014","307635"
"3","1.75","1710","10950","1060","650","1967","290000"
"3","1","1040","8199","1040","0","1953","285650"
"3","1.75","1840","16679","1840","0","1989","274950"
"2","1","800","1200","800","0","1999","269500"
"3","1.75","2050","10519","1240","810","1979","265000"
"2","1","810","4560","810","0","1928","260600"
"2","1","570","81893","570","0","1936","260000"
"3","1","1710","12000","1710","0","1972","255000"
"1","1","1180","22000","1180","0","1948","229500"
"3","1.5","1300","5000","900","400","1976","226500"
"3","1","1020","6000","1020","0","1900","210000"
"2","1","830","8000","830","0","1954","200000"
"2","1","940","8384","940","0","1947","121800"
"4","2.5","3280","7100","2180","1100","1911","2300000"
"4","3.25","3100","3900","2090","1010","1923","1450000"
"5","3","3850","14990","2290","1560","1964","1400000"
"4","3.75","4100","61419","4100","0","2014","1350000"
"5","4","3870","5929","3870","0","2014","1300000"
"4","2.25","3200","15367","3200","0","1962","1220000"
"6","2.75","3600","9675","1940","1660","1977","1000000"
"4","1.75","1780","11436","1780","0","1967","1000000"
"5","4.5","4280","8465","4280","0","2014","995500"
"4","2","2450","5000","2200","250","1919","969000"
"5","3.5","4510","16305","2820","1690","2003","960000"
"3","3","4040","14338","3030","1010","1986","950000"
"4","2.5","2670","5100","1940","730","1929","925000"
"4","2.75","4190","38912","2040","2150","1965","910000"
"4","3.25","3180","194278","3180","0","2005","890000"
"5","2.5","2530","8564","2530","0","1976","875000"
"4","2.5","2620","9525","2620","0","1974","838400"
"4","2.25","2600","10660","2600","0","1979","817000"
"4","2.5","3020","3600","3020","0","2009","805000"
"4","2.5","2990","9374","2990","0","2003","785000"
"4","3.25","3900","40962","3900","0","1991","780000"
"5","2.5","2600","4284","2600","0","2014","775000"
"3","1.5","1170","7645","1170","0","1955","760000"
"4","2.5","2920","7901","2920","0","2004","760000"
"4","1.75","2160","39430","1660","500","1974","753000"
"3","3.25","4610","81935","4610","0","1984","750000"
"3","2.5","2120","9307","2120","0","1984","719000"
"4","2","1760","7800","1760","0","1954","690000"
"3","2.5","2440","5750","1980","460","2000","679900"
"3","2.5","2680","28243","2680","0","1993","660000"
"3","1.75","1840","2310","1140","700","1914","650000"
"4","2.5","1910","1502","1910","0","2014","630000"
"6","3.5","2580","13572","1290","1290","1987","604000"
"3","2.5","2380","19860","2380","0","1995","582000"
"3","2.5","2150","4604","2150","0","2003","580000"
"5","3.25","3030","7410","2150","880","2014","580000"
"3","2.5","2070","3599","2070","0","1999","575000"
"3","1.5","1540","3570","1490","50","1930","565000"
"4","2.5","3220","5120","2420","800","2000","558000"
"2","2","1870","5580","1870","0","2004","554000"
"5","3","2320","7229","1370","950","1986","552500"
"3","1","2020","4120","1520","500","1929","552500"
"3","2.5","1380","1021","1160","220","2008","540000"
"4","2.25","1890","3615","1890","0","2005","535000"
"4","2.25","2130","7210","1330","800","1965","534000"
"4","2.75","2500","10330","1380","1120","1978","525000"
"3","2","1410","2700","1410","0","1902","520000"
"3","2.5","2100","213008","2100","0","1990","506000"
"3","1","1220","3400","1060","160","1927","500000"
"3","2.75","1830","208216","1830","0","1997","495000"
"3","1.75","2590","8384","1590","1000","1971","485000"
"3","2.5","2010","2386","1390","620","2014","479990"
"3","1.75","1370","8467","970","400","1972","460000"
"4","2.5","2820","6983","2820","0","2013","457000"
"4","2.25","2490","10720","1400","1090","1979","454800"
"3","2.25","2600","14810","1490","1110","1956","452000"
"3","2","1680","11250","1680","0","1967","450000"
"4","3.25","1960","7200","1960","0","1979","445000"
"3","2.5","2230","7934","2230","0","2005","445000"
"3","2.25","1980","8775","1290","690","1959","437000"
"3","1.5","1690","9708","1690","0","1954","430000"
"3","2.25","1670","9500","1170","500","1977","425000"
"4","2.5","2070","4427","2070","0","2007","425000"
"4","2.5","1900","2766","1900","0","2014","425000"
"4","1.75","1980","7840","990","990","1961","416000"
"3","1.75","2000","8400","2000","0","1959","415000"
"3","2.5","1690","1613","1150","540","2014","413565"
"5","2.75","2160","7200","1220","940","1955","402000"
"2","2","2010","3797","1450","560","1922","400000"
"3","2.25","1360","1041","1094","266","2006","399950"
"2","1","960","6700","960","0","1951","395000"
"3","1.5","1190","20672","1190","0","1948","375000"
"4","2.5","2190","17600","1110","1080","1966","370000"
"3","1.5","1640","8301","1290","350","1958","365000"
"3","1.5","1170","4080","1170","0","1917","360000"
"3","1.5","1060","5750","1060","0","1981","354000"
"3","2.5","2060","7458","2060","0","1989","348000"
"3","2.5","1650","13816","1650","0","1998","334999"
"4","1.75","1550","50094","1550","0","1967","330000"
"4","2.75","2475","4000","2475","0","2014","319900"
"3","1.75","1530","7650","1530","0","1977","317000"
"3","1.75","1490","7150","1490","0","1967","310000"
"3","2.25","1960","2345","1750","210","2003","310000"
"3","1.5","1340","13560","1340","0","1968","309500"
"3","2.5","2020","6628","1250","770","1963","300000"
"1","1","740","5000","740","0","1923","299000"
"4","2","2930","12840","2930","0","1965","294000"
"3","1","1400","9450","1060","340","1955","279000"
"5","1","1680","9383","1400","280","1929","274000"
"3","1.5","1380","11760","1380","0","1963","272000"
"5","1.75","1750","8325","1750","0","1966","269900"
"3","2","1210","7136","1210","0","2003","269000"
"3","2","1560","9635","1260","300","1966","260750"
"1","1","780","1033","780","0","1922","250000"
"3","1","990","8100","990","0","1949","250000"
"3","2","1850","8208","1180","670","1970","245000"
"3","1.75","1580","6099","790","790","1944","242000"
"6","1.75","2210","8594","1310","900","1959","240000"
"4","1.75","1570","18730","1200","370","1960","239900"
"3","2","1710","5000","1260","450","1968","237000"
"2","1","870","5000","870","0","1949","235000"
"3","1","1330","45738","1330","0","1967","235000"
"4","1.75","2020","7840","1010","1010","1968","220000"
"4","1.75","1530","18400","1530","0","1938","220000"
"2","2","1190","7570","1190","0","1939","210000"
"3","1.75","1080","9262","1080","0","1968","185000"
"2","1.75","1050","9800","1050","0","1975","175000"
"3","1.5","1570","6450","1570","0","1931","169000"
"4","2","1700","8043","850","850","1954","161000"
"3","3.25","3890","3452","2890","1000","2006","2250000"
"5","3.5","4390","6220","3170","1220","2013","1880000"
"5","5","5000","32909","5000","0","2000","1250000"
"4","2.25","2620","10920","2620","0","1965","950000"
"4","2.5","3300","101930","3300","0","1991","925000"
"3","2.5","2500","7746","1910","590","1993","895000"
"5","3.25","3420","5669","2620","800","2003","855000"
"3","1.75","2440","5800","1320","1120","1945","765000"
"3","3","1833","1706","1833","0","1998","719000"
"4","2.5","3100","36562","3100","0","1994","700000"
"2","1.75","1860","5940","1020","840","1956","672500"
"4","2.75","3020","13530","1540","1480","1977","670000"
"4","1.75","2540","7620","1320","1220","1948","655000"
"4","2.75","3160","8197","1580","1580","1962","655000"
"4","1.75","2340","5940","1290","1050","1953","650500"
"3","2.5","2500","51836","1510","990","2013","650000"
"4","2.5","2620","5450","2620","0","2001","648000"
"4","1.75","2100","3000","1500","600","1911","640000"
"3","3.25","1610","1275","1220","390","2005","630000"
"4","2.25","2390","8858","1740","650","1979","606000"
"4","2.75","2310","7851","1790","520","1989","592100"
"4","2.5","2510","47044","2510","0","1987","575000"
"3","2.5","2480","8676","2480","0","1989","555000"
"4","2.75","2230","9460","1480","750","1960","550000"
"3","1","1630","6009","1630","0","1954","550000"
"4","2.5","2040","7412","2040","0","1988","545000"
"3","2.5","2370","16455","1640","730","1959","540000"
"4","2.5","2490","8750","2040","450","1976","532500"
"3","2.25","1264","1536","1264","0","2003","530000"
"3","2","1530","3400","990","540","1907","529000"
"3","1.75","2300","43560","1350","950","1979","525000"
"5","2.5","2510","83231","1260","1250","1975","510000"
"3","2.5","1880","4668","1880","0","1993","509950"
"5","2.25","2060","9000","1320","740","1961","509500"
"3","1.75","1600","8400","1600","0","1963","480000"
"3","2","1290","1213","1290","0","2001","450000"
"3","1","1400","4800","700","700","1917","435000"
"3","2","1610","6911","1260","350","1988","435000"
"4","3.25","2820","13059","2820","0","1976","432000"
"5","2.75","2710","4685","2710","0","2014","430760"
"2","2.5","2420","60984","2420","0","2007","430000"
"3","3.25","1550","1444","1550","0","2006","430000"
"6","2.25","2930","15949","1730","1200","1965","429300"
"4","2.5","2390","5021","2390","0","2002","425000"
"4","2.25","2520","4200","1510","1010","1909","415000"
"2","1","800","5080","800","0","1938","404500"
"4","1.75","1910","77574","1910","0","1971","390000"
"4","1","1520","9800","1520","0","1971","389000"
"4","1.75","1800","10890","1800","0","1912","385000"
"2","2.5","1650","2710","1650","0","2008","382000"
"4","2.5","1867","15314","1867","0","2013","378950"
"4","2.5","1800","8432","1200","600","1960","375000"
"3","1.75","1390","9585","1390","0","1973","374150"
"5","3","2980","10064","1680","1300","1940","367500"
"2","1.75","1270","7500","1270","0","1982","365000"
"3","2","1950","8698","1950","0","1999","361000"
"2","1","1430","8157","1150","280","1944","350000"
"3","1","1370","8162","1370","0","1949","350000"
"2","3.25","1570","2031","1310","260","2006","349950"
"3","2","1640","4802","1640","0","2010","342000"
"3","1","1140","5258","1140","0","1911","329000"
"3","1.75","1980","7000","1360","620","1977","329000"
"4","1.75","1840","5100","1840","0","1933","327000"
"4","2.5","2030","4997","2030","0","2004","310950"
"2","1.5","950","676","850","100","2003","304000"
"4","2.5","1910","4862","1910","0","2005","300000"
"3","2.5","1260","3855","1260","0","1999","300000"
"2","1.75","2120","6350","1440","680","1924","300000"
"3","2.5","1880","4200","1880","0","2007","300000"
"3","2.5","1330","1200","1330","0","2002","300000"
"3","1","1280","5100","1280","0","1948","296500"
"2","1","1120","217800","1120","0","1976","290000"
"3","2.5","1940","9874","1940","0","1990","285000"
"4","2.5","1594","7665","1088","506","1975","269000"
"3","2.5","1760","6477","1760","0","1986","267000"
"3","1.75","1750","11180","1750","0","1968","260000"
"4","1.75","1900","22896","1360","540","1922","257000"
"2","1","790","7500","790","0","1950","245500"
"3","2.25","2210","10794","1540","670","1967","245000"
"2","1.5","1670","9880","1670","0","1941","240000"
"4","1.5","1760","6150","1760","0","1951","235000"
"3","1","1410","47916","1410","0","1981","211000"
"2","1","1000","6227","1000","0","1949","200000"
"4","1","1380","6700","1190","190","1928","185000"
"2","1","770","5200","770","0","1969","176000"
"4","2.5","3200","3600","2600","600","1997","1450000"
"4","2.25","2020","5800","1760","260","1941","1230000"
"5","3.25","4610","10576","3310","1300","2006","1200000"
"3","1.5","2560","4000","1660","900","1927","1090000"
"5","2.75","2500","19783","2500","0","1959","799000"
"4","3.5","3390","3960","3390","0","2008","775000"
"2","2.5","2280","6230","2280","0","2005","752500"
"4","2.25","2460","40635","2460","0","1968","715000"
"3","2.5","2290","9142","2290","0","1972","685900"
"4","2.25","2100","2500","2100","0","2001","650000"
"3","2","1980","6000","1380","600","1958","637000"
"3","3","2180","2650","1410","770","1930","634950"
"5","2","2330","6783","1310","1020","1956","630000"
"3","2.25","1660","3478","1100","560","1929","620000"
"4","2.5","2680","3626","1680","1000","1928","612000"
"4","2.5","2520","3980","2520","0","2005","598500"
"4","1","1550","4750","1550","0","1919","533000"
"4","1.5","1170","6240","1170","0","1960","525000"
"3","1.75","1560","16194","1560","0","1961","500000"
"2","1.5","1340","1286","1190","150","2006","485500"
"3","1.75","1710","4080","1130","580","1979","480000"
"3","2.5","1690","4898","1690","0","2003","464000"
"3","2.25","1960","6500","1960","0","1977","450000"
"4","2.5","2500","36254","1590","910","1978","450000"
"4","1.75","1520","5250","1520","0","1949","450000"
"3","3.25","1770","1863","1430","340","2003","450000"
"3","1","1050","5500","930","120","1920","435000"
"3","2.5","2075","16200","2075","0","2002","433200"
"3","2","1920","7200","1300","620","1984","433000"
"4","1.75","1940","11500","1090","850","1955","420000"
"3","2.5","1470","1571","1180","290","2007","420000"
"4","2.5","2260","5164","2260","0","1996","419950"
"4","2.25","1630","7969","1100","530","1977","412500"
"3","1.75","1440","7112","1180","260","1979","410000"
"4","1.75","2220","4760","1320","900","1918","397500"
"3","2.5","1690","10113","1310","380","1991","390000"
"3","2.5","2320","5760","1480","840","1987","375000"
"4","1","1450","6820","1450","0","1947","375000"
"2","1","820","4050","820","0","1949","370000"
"4","2.75","2420","6495","2420","0","2005","369000"
"5","2.5","2170","2752","2170","0","2014","359800"
"2","2.5","1370","1140","1080","290","2009","355000"
"3","1","1390","4820","910","480","1926","350000"
"4","2","1740","6369","870","870","1954","339999"
"3","1.5","1900","7584","1900","0","1962","335000"
"4","1.5","1870","7220","1870","0","1956","325000"
"4","2.75","2640","7500","1620","1020","1967","320000"
"4","2.5","1930","8336","1930","0","1995","319000"
"3","2.25","1440","3488","1440","0","1983","313500"
"2","1","860","3300","860","0","1903","311000"
"4","2.5","2690","6124","2690","0","2007","311000"
"3","1.5","1140","3104","1140","0","1988","310000"
"2","1","880","5500","880","0","1904","292000"
"4","1","1900","8505","1200","700","1956","270000"
"2","1","1747","12250","1747","0","1948","267500"
"2","1","900","7500","900","0","1961","252500"
"3","1","1700","7700","1120","580","1960","250000"
"2","1","930","12724","930","0","1912","230950"
"2","0.75","840","49658","840","0","1948","210000"
"2","1","790","14200","790","0","1951","198000"
"3","1.75","1580","7875","1580","0","1979","195000"
"3","1","1010","10215","1010","0","1955","180000"
"7","4.75","5310","8816","3650","1660","2013","2300000"
"3","3.25","3230","7800","3230","0","2005","1780000"
"4","3.5","4330","15335","3230","1100","1988","1700000"
"4","3.25","4670","51836","4670","0","1988","1580000"
"4","2.5","4010","37076","4010","0","1990","1330000"
"9","4.5","3650","5000","2530","1120","1915","1280000"
"4","2.5","2910","9131","2910","0","2014","1040000"
"4","3.75","4690","207141","4030","660","2007","1020000"
"4","2.5","3470","20445","3470","0","1963","994000"
"3","3.25","2620","7215","1770","850","1980","900000"
"5","4","3400","5000","2320","1080","1900","870000"
"4","2.75","2810","10300","1810","1000","1978","812500"
"4","2.75","3100","7501","3100","0","1998","795000"
"3","2.5","1940","4000","1940","0","1906","725000"
"4","2.25","2880","8882","2480","400","1965","725000"
"4","3.5","3510","9263","3510","0","2001","723000"
"3","1","1610","7680","900","710","1956","715000"
"3","2.25","1590","929","1060","530","2014","665000"
"3","2.5","1780","11000","1210","570","1980","635000"
"4","2.5","2290","26720","2290","0","1977","630000"
"4","1.75","2270","9830","2270","0","1959","615000"
"3","2.5","2260","33042","1660","600","1986","610000"
"3","2.5","2210","8622","2210","0","1988","590000"
"3","2.5","1660","1458","1660","0","2014","559950"
"3","1.75","1830","9720","1150","680","1928","550000"
"6","1.75","1820","6250","1130","690","1954","545000"
"2","1","910","295772","910","0","1953","533050"
"4","2.75","2050","7171","1540","510","1988","528000"
"4","2.25","1890","3006","1890","0","2003","520000"
"4","2.5","2550","17209","2550","0","1996","512000"
"4","2.5","2590","9354","2590","0","1993","500000"
"5","2.5","3180","23809","3180","0","1978","499950"
"3","2.25","3010","9600","2410","600","1978","499000"
"5","2.75","2630","10165","1690","940","1976","495000"
"2","1.5","1000","5125","1000","0","1942","488000"
"4","1.75","2430","9747","1780","650","1974","459950"
"3","2.5","2470","4565","2470","0","2005","445000"
"3","2.25","1860","7200","1240","620","1977","445000"
"3","2.5","1980","39932","1980","0","1994","442000"
"2","1","970","2700","770","200","1926","425000"
"5","3.5","2760","3865","2760","0","2013","424950"
"5","3.5","2760","3846","2760","0","2013","424950"
"3","1.5","1470","11112","1470","0","1954","418900"
"2","1","770","2971","770","0","1923","407500"
"2","1","880","1448","880","0","1927","405000"
"2","1","1400","8220","1400","0","1949","401000"
"3","2","1940","16300","1140","800","1978","399000"
"3","1","1030","10480","1030","0","1954","397500"
"3","2.25","1430","1383","1430","0","2005","397500"
"4","3","2570","262018","1420","1150","1988","390000"
"3","1.75","1870","40250","1870","0","1959","390000"
"3","2.5","2198","6222","2198","0","2010","388000"
"3","2.5","1350","886","1270","80","2006","377500"
"3","2.5","2190","5091","2190","0","2004","365000"
"4","2.5","2575","4725","2575","0","2011","359000"
"4","3","2050","4000","2050","0","2014","353500"
"3","2.5","1540","3237","1540","0","1999","345000"
"4","2.5","2623","7184","2623","0","2012","333000"
"5","2.5","2600","3839","2600","0","2005","330000"
"3","1","1010","7200","1010","0","1948","318000"
"2","1.5","1150","3927","1150","0","1982","300000"
"3","1","1200","15843","1200","0","1955","299000"
"3","2.5","1670","6186","1670","0","2002","289950"
"3","2.25","1860","9210","1860","0","1994","280000"
"4","1.75","1940","7500","1720","220","1966","274000"
"3","2","1200","5700","1200","0","1942","272000"
"3","2.5","1980","6608","1980","0","1994","272000"
"5","2.5","2630","8470","2630","0","1968","270000"
"3","2.25","1470","16728","1350","120","1959","270000"
"3","1.75","2270","9000","1330","940","1978","258000"
"4","2.5","1700","4268","1700","0","2000","245000"
"2","1","720","6321","720","0","1940","235000"
"4","1","1500","6360","1500","0","1944","235000"
"3","1.75","1350","9793","1350","0","1968","225000"
"2","1","1010","4120","1010","0","1907","219950"
"4","1","1200","43560","1200","0","1968","210000"
"2","1","700","5200","700","0","1952","199950"
"2","1","1040","13920","1040","0","1973","182500"
"3","3.25","1760","1778","1760","0","2008","469950"
"3","1.75","1300","5000","1300","0","1964","249000"
"3","2.5","1430","2200","1430","0","1910","720001"
"3","2.5","2150","11672","2150","0","2004","378000"
"4","2.25","2320","16800","2320","0","1977","260000"
"3","3.5","4410","10756","3430","980","2014","3000000"
"4","5","6055","21630","3555","2500","1996","1760000"
"3","2.25","2610","9409","2610","0","1963","1520000"
"4","3","3110","4408","2510","600","1931","1420000"
"4","3.5","4010","15365","4010","0","2006","1390000"
"4","3.25","2850","4800","2700","150","1905","1330000"
"3","2.25","2930","7005","2670","260","1999","1050000"
"4","3.5","3130","5000","3130","0","2014","1010000"
"5","3.5","4390","10140","3350","1040","2005","971000"
"4","1.75","2630","9645","2630","0","1963","968000"
"3","1.75","2460","4800","1230","1230","1938","960000"
"5","3","2710","4200","1890","820","1919","925000"
"5","2.75","3170","8093","3170","0","2014","890776"
"4","2.75","3220","15467","3220","0","1994","890000"
"2","2","1313","3600","1313","0","1904","885000"
"5","2.25","2910","9525","2910","0","1968","870000"
"4","2.75","3390","6298","3390","0","2011","859900"
"3","2.5","3050","33920","3050","0","2004","840000"
"5","4","4280","11307","2710","1570","1996","839000"
"4","2.5","2570","50308","2570","0","1993","800000"
"4","2.5","2490","5647","2490","0","2014","778983"
"4","2.25","4220","24186","2600","1620","1984","775000"
"3","2.5","3380","7126","3380","0","1965","749000"
"3","2.25","2350","6000","1020","1330","1948","735000"
"3","2.5","2160","9888","2160","0","1989","733000"
"3","2.5","3410","41022","3410","0","1990","725000"
"5","2.75","2860","5379","2860","0","2005","720000"
"4","2","2070","7830","1180","890","1941","699950"
"4","2.75","2520","8433","2520","0","2014","689950"
"3","2.25","1820","8316","1320","500","1960","680000"
"4","2.5","2460","9973","1560","900","1965","640000"
"2","1.75","1780","4520","890","890","1925","639950"
"3","2.5","2010","3300","1610","400","2014","639000"
"4","2.25","1530","7845","1030","500","1981","620000"
"4","2.5","2670","5895","2670","0","1999","603000"
"4","1.75","1810","5562","1390","420","1977","600000"
"3","1.75","1650","1180","1650","0","2014","599000"
"3","1.75","2220","216493","2220","0","1989","585000"
"2","1.75","2770","19700","1780","990","1983","575000"
"3","2.5","3150","20189","3150","0","1990","570000"
"4","2.25","2060","8767","2060","0","1983","543000"
"3","1.75","1650","10150","1230","420","1976","539900"
"5","3","3040","6604","3040","0","2005","538900"
"3","1","1660","5100","1260","400","1957","535000"
"3","2.5","2160","7500","1430","730","1979","532500"
"3","2.5","3430","48993","3430","0","2001","515000"
"3","2.5","2610","5845","2610","0","2005","515000"
"5","2.5","3361","6983","3361","0","2006","511000"
"6","2.75","2890","7500","1830","1060","1976","508000"
"2","1","970","4284","970","0","1905","495000"
"3","1","1060","8625","1060","0","1962","476500"
"3","2.5","1670","3980","1670","0","2000","475200"
"3","1.75","1550","4054","1550","0","1926","475000"
"3","2.5","2460","5400","1520","940","2001","464000"
"3","1.75","2340","51836","1510","830","1978","459900"
"3","2.75","2720","31314","2720","0","1986","455000"
"9","7.5","4050","6504","4050","0","1996","450000"
"3","1","1290","5440","790","500","1929","450000"
"4","2.5","2692","8392","2692","0","2014","436472"
"3","3.25","2210","3600","1820","390","1995","429000"
"3","3","2700","47050","1570","1130","1986","420000"
"3","2.75","2300","8000","1430","870","1965","420000"
"3","2.75","3900","111514","3460","440","1967","415000"
"4","2.5","2230","5743","2230","0","2002","415000"
"4","1.75","1640","10500","1010","630","1968","402000"
"3","1","1460","43000","1460","0","1952","400000"
"3","2.5","2393","4788","2393","0","2012","400000"
"4","3","3000","10297","3000","0","2003","398950"
"2","1","930","3100","930","0","1911","390000"
"4","2.5","2810","11897","2810","0","2003","386000"
"3","1.75","1330","7216","1330","0","1969","381000"
"3","2.5","1730","7202","1330","400","1991","379260"
"4","2.25","1930","7925","1300","630","1960","367500"
"3","2","1350","10200","1350","0","1977","366000"
"3","2.5","1590","4242","1590","0","2000","355000"
"3","2.25","1870","7200","1390","480","1975","350500"
"3","1.5","1320","4400","1320","0","1909","350000"
"3","2.5","1580","2765","1580","0","2011","349900"
"3","2","1140","11620","1140","0","1994","340000"
"3","2.5","2440","7632","2440","0","1998","335000"
"3","2","1700","8160","1120","580","1961","334500"
"2","1","1070","9750","1070","0","1947","327000"
"2","1","1100","17817","620","480","1980","325000"
"2","2.5","1280","819","1060","220","2006","319950"
"4","2.5","2150","9000","1360","790","1979","317500"
"4","2.5","1870","8449","1870","0","1992","314000"
"3","2.5","2460","5027","2460","0","2002","305000"
"3","2.25","1450","7562","1450","0","1994","297000"
"3","1.75","1440","4000","1050","390","1979","295000"
"3","2.5","1560","2740","1560","0","1999","292000"
"3","2.5","1670","6666","1670","0","1992","290700"
"2","1.5","1076","1060","1076","0","2006","290000"
"3","2","2860","24046","1700","1160","1985","289275"
"2","1","720","5000","720","0","1951","280000"
"3","1.5","1450","4694","1450","0","2011","274000"
"3","1.75","1390","9000","1390","0","1978","270000"
"4","2.5","2060","13500","1260","800","1968","269950"
"3","1","1220","20400","1220","0","1959","253500"
"2","1","770","2191","770","0","1937","252500"
"3","1","1100","7657","1100","0","1955","233000"
"3","1","1370","56628","1370","0","1942","229000"
"3","1.5","1200","5000","1200","0","1979","229000"
"3","2","1230","1340","1020","210","2003","209000"
"3","1","1490","5000","1490","0","1963","205950"
"1","1.5","1048","4800","1048","0","1942","199950"
"3","1","1060","10023","1060","0","1962","169500"
"2","1","900","6400","900","0","1940","140000"
"4","3.25","7000","28206","3500","3500","1991","3200000"
"5","3.25","5210","35765","4940","270","1911","2200000"
"4","4.5","4240","13162","4240","0","2004","2190000"
"4","3.5","4610","12500","4610","0","2003","1650000"
"3","2.5","3910","14000","3910","0","1999","961500"
"4","3","3140","9058","2140","1000","1989","946000"
"4","1.75","2710","11400","1430","1280","1976","925000"
"4","2.5","3210","8532","3210","0","1998","915000"
"3","1.5","2420","5000","2200","220","1925","870000"
"3","2.25","1950","3600","1430","520","1911","850000"
"4","2.75","2400","12469","1760","640","1958","839000"
"2","1","1450","7098","1450","0","1924","822500"
"4","3.5","4170","4322","2940","1230","2005","810000"
"3","2.25","1860","1386","1860","0","2014","799950"
"4","3.5","2720","3000","2250","470","2014","790000"
"2","0.75","1260","4800","1080","180","1942","785000"
"1","1","1180","4000","840","340","1910","713000"
"4","2.5","2780","6235","2780","0","2001","690000"
"3","2.5","2250","4134","2250","0","2004","675000"
"3","3.5","2480","10800","2480","0","1998","640000"
"4","1.75","1830","6000","930","900","1939","639000"
"5","1.75","1880","18295","1880","0","1955","618000"
"3","1","1440","4300","1440","0","1929","600000"
"4","2.25","2050","8372","2050","0","1984","595000"
"4","2.5","2340","8971","2340","0","1987","590000"
"4","1.75","1920","208652","1060","860","1919","589000"
"3","3","1720","954","1460","260","2006","589000"
"5","2.75","3160","10059","1740","1420","1978","540000"
"3","2.25","2130","12286","2130","0","1977","534950"
"3","2.25","2240","6450","1440","800","1979","527000"
"3","1.75","1710","9707","1710","0","1966","522500"
"2","1","1640","14100","1140","500","1954","500000"
"5","3.5","2815","4900","2815","0","2011","491000"
"3","1","1270","8000","1270","0","1959","475000"
"2","1","1050","403365","1050","0","1905","474000"
"5","2.5","2970","24759","1670","1300","1969","469500"
"4","2.25","3360","10810","3360","0","1988","465000"
"2","1.5","1220","1120","1110","110","2008","465000"
"3","2.5","1600","7829","1600","0","1987","455000"
"4","3","2800","7198","2800","0","2002","444000"
"3","2.5","1930","7120","1420","510","1961","432500"
"3","1","1320","7076","1320","0","1959","425000"
"3","2","2020","38332","1010","1010","1975","420000"
"3","2.5","2060","7020","1460","600","1967","420000"
"2","1","1070","6100","1070","0","1940","406650"
"2","1","1090","10481","780","310","1981","405000"
"4","1","1060","5750","950","110","1904","403504"
"4","2.5","3140","94525","2280","860","1977","401500"
"4","1.75","1810","9750","1810","0","1977","400000"
"3","1.5","1360","1488","1120","240","2003","396500"
"4","2.75","1790","47250","1220","570","1987","390000"
"4","2.75","2500","12848","2120","380","1975","390000"
"3","1.75","2160","5863","1260","900","1928","385000"
"4","2.5","2370","10580","2370","0","1966","383000"
"5","2.75","3060","6895","3060","0","2003","381000"
"4","2.5","2500","11070","1300","1200","1964","380000"
"4","2.5","2300","7707","2300","0","2004","380000"
"3","2","1670","13775","1670","0","1968","375000"
"4","1.75","1940","15909","970","970","1974","375000"
"4","2.5","1790","6120","1790","0","2005","370500"
"5","1.75","2810","9360","1520","1290","1965","368500"
"4","2.5","2470","6116","1420","1050","1985","352000"
"4","2.5","2260","13755","2260","0","1975","350000"
"6","3.25","2120","6893","1060","1060","1983","330000"
"3","1.75","1340","4548","1340","0","1961","330000"
"3","2.25","1500","9656","1170","330","1989","329500"
"2","1","830","8183","830","0","1950","327500"
"4","2.5","1630","5361","1630","0","1999","327000"
"3","2.5","1782","1577","1782","0","2000","326000"
"4","2.5","1960","3543","1960","0","2004","325000"
"2","1","1400","10800","1400","0","1974","325000"
"4","2.25","2190","9020","2190","0","1978","320000"
"4","2.5","2070","7007","2070","0","1996","320000"
"3","2.25","1900","7479","1900","0","1992","316000"
"4","2.5","2080","5650","1680","400","1950","315000"
"4","2.5","2007","4968","2007","0","2009","305950"
"4","2.25","2050","12581","2050","0","1978","305000"
"4","1.75","2340","7200","1590","750","1960","290000"
"4","2.25","2100","8050","2100","0","1978","283500"
"3","2.5","1370","22326","1370","0","1993","280000"
"3","1.5","1780","16000","1240","540","1960","279000"
"3","2.25","1400","3825","1400","0","2012","270000"
"4","1.75","1670","8000","1670","0","1974","268500"
"5","3.5","2390","6600","2390","0","1977","267500"
"3","2","1850","16535","1850","0","1992","265000"
"3","1","1660","11200","1660","0","1957","261000"
"3","1","1250","9472","1250","0","1972","255000"
"3","1","1100","8138","1100","0","1949","241450"
"3","2","1210","6634","1210","0","1985","237000"
"2","2.5","1360","2693","1360","0","2003","225000"
"3","1.5","1660","7221","980","680","1962","225000"
"3","2.25","1430","5999","1430","0","1987","221000"
"3","1.5","1200","12000","1200","0","1986","219000"
"2","1","1010","6000","1010","0","1944","215000"
"2","1","820","4860","820","0","1955","207000"
"3","2","1390","10155","1130","260","1980","190500"
"2","1.5","1400","9031","960","440","1982","190000"
"2","1","900","8000","900","0","1954","185000"
"2","1","670","5140","670","0","1926","183000"
"3","1","1040","7500","1040","0","1954","172500"
"4","3.25","3800","19798","3800","0","1969","2400000"
"4","2.75","3670","15400","3670","0","1986","1220000"
"4","2.75","3950","12840","3950","0","1960","1050000"
"4","4.5","3180","4606","1990","1190","1929","1050000"
"3","2.5","2700","6947","2700","0","2013","950000"
"4","2","1710","4178","1710","0","1926","895000"
"4","2.5","3070","8250","2100","970","1958","880000"
"3","2.5","3210","5414","2530","680","1990","870000"
"3","2","3120","9400","1820","1300","1978","855000"
"4","3","3310","4500","2910","400","1900","829000"
"3","2.75","3040","24192","3040","0","1987","825000"
"2","1.75","2110","8700","1760","350","1960","802000"
"2","1","1050","8750","1050","0","1951","800000"
"4","2.75","3350","5416","3350","0","2014","790500"
"4","2.75","2840","11900","1640","1200","1961","790000"
"4","2.75","2740","6200","1820","920","1947","775000"
"4","2.5","2500","8680","1250","1250","1958","772000"
"3","2.75","2250","9600","1830","420","1909","765000"
"3","2.25","2250","5301","1510","740","1975","750000"
"3","3.75","2460","7630","1940","520","1976","750000"
"4","3","3350","199253","3350","0","2004","740000"
"4","2.5","2450","7700","1250","1200","1958","715000"
"3","2.5","2580","4636","2580","0","2006","698000"
"5","2.75","3600","9437","3600","0","2014","679950"
"4","1.75","2000","5100","1130","870","1949","595000"
"3","2","1850","9570","950","900","1940","547500"
"3","2.5","1900","3366","1900","0","1996","545000"
"3","2","1560","3200","1560","0","1910","539950"
"3","2.75","1320","1125","1320","0","2008","535000"
"4","1.75","1990","12950","1850","140","1968","524400"
"4","2.5","2280","8798","2280","0","1987","520000"
"4","2.5","2560","5672","2560","0","2005","518000"
"3","1","1270","8000","1270","0","1957","510500"
"3","2.75","1560","77536","1400","160","1978","500000"
"3","2.5","1460","1614","1180","280","2007","499000"
"3","2","2370","12196","2370","0","1970","490000"
"5","3.5","3530","218472","2380","1150","1999","487500"
"6","2.5","3300","13501","2060","1240","1980","484000"
"2","1.75","1170","4635","690","480","1924","480000"
"3","1.75","2790","36585","1410","1380","1970","478000"
"3","1","1380","4635","1380","0","1919","475000"
"3","2.5","2160","35912","2160","0","1982","475000"
"3","1","1170","4400","870","300","1951","470000"
"4","2.5","1990","30083","1990","0","1998","470000"
"4","2.25","2140","7701","1470","670","1977","465000"
"3","2.5","1670","2589","1670","0","2000","450000"
"3","1.75","1780","7567","1290","490","1980","442573"
"6","3.5","2400","8620","1640","760","1987","435000"
"3","2","1380","2500","750","630","1986","435000"
"3","1.75","1150","7700","1150","0","1957","415950"
"1","1","760","3000","760","0","1900","415000"
"3","2.5","1950","7263","1950","0","2007","409000"
"3","3","1500","1473","1120","380","2000","408000"
"4","2.5","2927","6000","2927","0","2011","407000"
"2","2.5","1590","1679","1590","0","2012","395825"
"2","1.5","940","5000","810","130","1925","392000"
"3","2","2360","5737","2360","0","2003","390000"
"3","1.75","1800","18000","1200","600","1968","385000"
"2","2","1370","5756","1370","0","1986","380000"
"6","2.5","2420","11662","1420","1000","1965","376000"
"4","2.25","2100","12738","2100","0","1975","375000"
"4","2.25","1920","9660","1920","0","1968","372500"
"3","1.75","1750","10800","1750","0","1951","368000"
"3","1.75","2290","8234","1250","1040","1950","367950"
"3","1.75","2000","12669","1200","800","1965","367000"
"5","2.75","3260","9253","3260","0","2004","365000"
"3","2","1320","1298","1320","0","1995","350000"
"3","2","1680","2500","1680","0","1991","350000"
"2","1.75","1660","11437","1660","0","1958","335000"
"4","2.5","2080","7000","1400","680","1989","330000"
"3","2","1760","43575","1160","600","1988","322000"
"5","2.5","3220","5751","3220","0","2002","315000"
"4","1.75","1880","12150","1280","600","1976","310000"
"1","1","1120","11800","1120","0","1950","309950"
"4","1.75","1000","7200","1000","0","1947","305000"
"4","2.5","2510","12000","1520","990","1977","305000"
"3","1.75","2100","15480","2100","0","1983","299000"
"3","1","960","169448","960","0","1955","299000"
"3","2.5","1690","7460","870","820","1997","285000"
"1","1.75","1010","10900","1010","0","1968","283700"
"4","2.25","2400","7738","2400","0","1964","278000"
"2","1.75","2090","11317","1090","1000","1931","275000"
"3","1.5","1740","9547","1740","0","1962","269950"
"3","1.75","2120","18335","1380","740","1961","249000"
"4","2.25","2080","7526","1280","800","1985","231500"
"4","1","1150","6000","1150","0","1907","225000"
"3","1.75","1070","7200","1070","0","1994","224400"
"3","1","1150","7260","1150","0","1959","221000"
"3","2.25","1470","7518","1160","310","1985","220000"
"3","1.75","1310","8670","1310","0","1984","216000"
"3","1","1430","7000","1430","0","1968","213950"
"3","1","860","7740","860","0","1960","207000"
"5","2.5","1720","10202","1720","0","1970","206325"
"2","1","880","4000","880","0","1916","199400"
"3","1.75","1320","17390","1320","0","1956","199000"
"3","1","920","5200","920","0","1969","179000"
"5","2.25","2800","8442","2800","0","1963","1850000"
"3","3.25","4160","35153","3690","470","2001","1700000"
"5","3.75","4960","13990","3760","1200","2001","1360000"
"5","4","2710","2800","2380","330","1974","1200000"
"5","2.75","2910","15118","1780","1130","1972","1170000"
"10","5.25","4590","10920","2500","2090","2008","1150000"
"3","3","3700","16857","2170","1530","2000","1100000"
"4","2.75","3430","15877","3430","0","2005","1010000"
"3","2.25","2390","4590","2090","300","1941","980000"
"6","3","3420","22421","2270","1150","1948","975000"
"4","2.5","2790","15653","2790","0","1964","950000"
"4","2.5","3680","11648","3680","0","1986","909000"
"4","2.5","3690","8507","3690","0","1987","900000"
"4","3.5","3210","5000","3210","0","2014","889000"
"6","3.25","2820","4536","1930","890","1917","875000"
"3","2.25","2520","6690","1700","820","1944","835000"
"3","1.75","1850","6000","1650","200","1913","819000"
"5","1.75","1930","501376","1930","0","1930","800000"
"4","3.5","3310","4850","3310","0","2010","785000"
"4","2.5","2750","16139","2750","0","1989","763776"
"4","3","2840","5560","1990","850","1974","760000"
"7","3.75","2310","5000","2310","0","1984","727160"
"4","3","3400","292723","3400","0","1998","688000"
"4","2.5","2650","25248","2330","320","1954","685000"
"3","2.5","2300","9218","2300","0","1998","683000"
"5","2.75","2760","5000","2760","0","2005","682000"
"8","2.75","2530","4800","1390","1140","1901","680000"
"3","2.5","2770","9350","2770","0","1957","679000"
"5","2.75","2160","4000","1530","630","1927","671500"
"5","2.5","2560","46786","2560","0","1995","655000"
"4","2.25","1960","9021","1960","0","1973","610000"
"4","3.5","2160","3600","1660","500","1998","601000"
"4","2.25","2270","10000","1720","550","1974","596000"
"4","1.75","2410","8447","2060","350","1936","550000"
"4","2","2100","8880","2100","0","1958","548000"
"4","2.5","1850","7850","1850","0","1985","540000"
"4","1.75","1630","6120","980","650","1918","540000"
"4","1.75","2260","19500","1450","810","1971","540000"
"3","2.5","3150","21893","3150","0","2006","530000"
"6","3","2880","7560","2880","0","1980","525000"
"3","2.25","1810","8158","1450","360","1984","507000"
"3","2.5","3040","5326","3040","0","2008","500000"
"3","2.25","2990","216057","2990","0","1994","500000"
"5","1.75","2460","14100","1380","1080","1972","485000"
"2","1","1130","3800","1130","0","1916","485000"
"3","1","1360","3880","1060","300","1963","466950"
"3","2.25","1850","7923","1150","700","1977","461000"
"3","1.75","1810","12600","1400","410","1977","450000"
"3","2.5","2450","19744","2450","0","1990","450000"
"4","2.5","2290","5515","2290","0","2006","450000"
"3","1.75","1470","7590","1470","0","1988","449950"
"3","2.5","1650","3076","1650","0","2003","447000"
"3","1.5","1480","7749","1480","0","1960","446450"
"3","2.5","1550","930","1060","490","2006","445000"
"3","2.5","2060","11231","2060","0","1987","440000"
"3","2.5","2150","9266","2150","0","1988","428040"
"4","1.75","1700","9000","1700","0","1967","423000"
"2","1","1070","4500","1070","0","1937","415000"
"6","2","2350","6554","2000","350","1905","400000"
"3","2.5","1920","12244","1920","0","1998","380600"
"3","2","3120","42247","2150","970","1980","375000"
"4","2.5","2310","7800","2310","0","2011","375000"
"4","1.5","1970","14490","1970","0","1963","374950"
"4","2.5","2080","11050","2080","0","1969","364000"
"3","1.75","2200","11520","2200","0","1952","359000"
"1","1","900","6380","900","0","1947","350000"
"3","2.5","1740","9134","1320","420","2008","342000"
"2","1","1120","7440","1120","0","1939","335900"
"2","0.75","520","6862","520","0","1924","330000"
"4","2.5","1990","3980","1990","0","2002","328000"
"4","1.75","2320","9240","1160","1160","1959","324950"
"2","1","820","8370","820","0","1941","324000"
"5","2.5","2500","13034","1300","1200","1962","323000"
"3","2.5","2020","26670","2020","0","1987","309900"
"4","2.5","2267","3577","2267","0","2014","306000"
"3","2.5","1840","8234","1840","0","1994","297000"
"4","2.5","2040","7800","2040","0","2003","294000"
"3","1","960","6400","820","140","1944","289500"
"4","1.5","1940","6386","1140","800","1954","280000"
"4","1.75","1850","7730","1100","750","1956","270000"
"3","2","1300","1920","850","450","2006","270000"
"1","0.5","880","1642","500","380","1910","255000"
"3","2.25","1830","7770","1400","430","1977","255000"
"3","1.75","1320","10454","1320","0","1968","249950"
"2","1","720","5160","720","0","1949","248500"
"3","2","2040","13125","810","1230","1910","245000"
"3","3","2110","7794","2110","0","1981","243500"
"3","1","1120","10665","1120","0","1961","225000"
"3","1.5","1070","9331","1070","0","1956","220000"
"3","1","1460","5000","1460","0","1957","220000"
"3","1","1400","7800","1400","0","1962","217000"
"3","2","1050","18304","1050","0","1953","169100"
"3","3.75","6030","39317","4440","1590","1991","1830000"
"5","3.5","4370","12240","3270","1100","1990","1500000"
"4","3.5","3560","16782","2560","1000","2014","1400000"
"4","3.5","3700","13175","3700","0","1989","1290000"
"4","2.5","3770","10893","3770","0","1997","1040000"
"3","3","2560","3600","2110","450","1994","925000"
"4","3.25","3640","60086","3640","0","2005","925000"
"4","2.75","3950","10214","2050","1900","1955","900000"
"4","2","1980","7200","1700","280","1910","900000"
"4","3.5","2970","5000","2200","770","2001","866800"
"4","3.25","3090","67518","3090","0","1988","844000"
"3","2.5","2970","9600","2970","0","1994","820000"
"3","2","2090","5015","2090","0","1920","785000"
"4","2.75","3430","6500","3050","380","2006","780000"
"4","2.5","2990","9643","2990","0","2003","772000"
"3","1.75","2280","7800","1360","920","1941","750000"
"4","2.5","2500","10330","2500","0","1992","740000"
"3","1.75","1740","3060","950","790","1930","733000"
"4","2.5","3420","17038","3420","0","2007","720000"
"3","2.75","2930","218235","2930","0","1990","710000"
"2","1","1260","5800","1260","0","1939","661000"
"3","1.75","980","6002","980","0","1942","657500"
"3","2","1340","2720","1340","0","1913","650000"
"3","1","1530","4944","1530","0","1950","640000"
"4","2.25","2070","7200","1390","680","1977","625000"
"3","2","2060","4080","1060","1000","1921","607000"
"3","2.25","2680","41250","2680","0","1984","590000"
"2","1.5","1780","4750","1080","700","1947","555000"
"4","2.5","2060","9719","1320","740","1960","550000"
"3","1.75","1700","5750","1450","250","1925","545000"
"2","1","920","4000","920","0","1906","514000"
"3","1.5","1220","962","1220","0","2014","500000"
"3","1.75","1730","9334","1220","510","1977","499990"
"4","3","2740","2811","2240","500","2003","495000"
"3","1.75","1490","11360","1490","0","1975","490000"
"5","2.5","2010","3600","1510","500","1912","475000"
"3","2.5","2770","98881","2770","0","1991","475000"
"3","2.5","1340","10018","1340","0","1976","425000"
"3","2","1740","18000","1230","510","1989","405000"
"2","1.5","1160","1648","1160","0","2002","375000"
"3","2","1400","2445","840","560","2002","373000"
"3","1","1010","3060","1010","0","1904","345000"
"4","2.5","2060","5607","2060","0","2002","343888"
"1","1","860","4800","860","0","1907","330000"
"3","1","1040","11900","1040","0","1972","330000"
"3","2.5","1830","12750","1830","0","1991","300000"
"4","2","1580","9600","1050","530","1965","300000"
"3","1.5","1190","785","920","270","2014","277140"
"4","2.5","2180","11132","1620","560","1978","275000"
"2","1","1140","74052","1140","0","1968","269500"
"2","1","770","5160","770","0","1943","265000"
"3","1.5","1350","7827","1350","0","1968","259950"
"3","1","1370","11658","1370","0","1958","249950"
"4","2","1670","5200","1030","640","1977","229999"
"3","2","1440","7187","970","470","1981","222000"
"3","1","1200","8316","1200","0","1953","214000"
"3","1","1170","8816","1170","0","1966","207500"
"2","1","840","12252","840","0","1994","190000"
"2","1.75","1050","2926","1050","0","1974","187000"
"2","1","880","9000","880","0","1928","130000"
"4","3.75","3550","15151","3550","0","2004","959900"
"5","2.5","2840","5000","1620","1220","1913","739000"
"3","1","1330","5850","930","400","1954","320000"
"2","1","740","6840","740","0","1942","250000"
"4","2.5","2810","52062","2810","0","1988","855000"
"3","2.5","2830","9680","2830","0","1991","710000"
"3","2.5","3440","18167","3440","0","1991","610000"
"3","1.75","1240","8611","1240","0","1973","380000"
"4","3","2570","4000","1750","820","1909","1180000"
"5","4.25","4610","13252","4610","0","2004","1170000"
"4","2.5","2430","6325","2020","410","1919","990000"
"4","2.5","3780","10962","3780","0","1990","980000"
"4","3.5","3560","7178","2590","970","2006","833000"
"3","2","1870","9527","1870","0","1951","832500"
"4","2.5","3520","9901","3520","0","1998","828000"
"3","2.5","2040","10033","1420","620","1974","726000"
"5","2","3180","10800","1910","1270","1968","708000"
"6","2","2570","4240","1970","600","1911","705000"
"4","2.5","2780","4688","2780","0","2003","690000"
"4","2","2240","11040","1120","1120","1961","649000"
"4","3.25","2760","4104","1900","860","2014","641000"
"3","2.5","2580","7500","2580","0","1991","640000"
"3","1.75","2360","4063","1180","1180","1940","631750"
"2","1.5","1490","5750","1190","300","1900","625000"
"3","1","1240","4080","1240","0","1925","625000"
"4","1.75","2710","9216","1440","1270","1961","624000"
"2","2.5","1830","1988","1530","300","2011","600000"
"5","2.5","3110","15783","1720","1390","1974","580000"
"3","1","1500","4500","1120","380","1938","578000"
"3","1.75","1470","5000","1470","0","1900","554600"
"4","2.5","2890","9045","2890","0","2001","550000"
"5","3","3100","5250","3100","0","2006","539950"
"3","2.5","2790","19485","2790","0","1990","535000"
"3","2.25","2010","5133","2010","0","1986","530000"
"4","1.5","1740","8160","1400","340","1946","515000"
"4","1","1060","7200","880","180","1925","510000"
"3","1.5","1960","8815","1020","940","1958","500000"
"3","1","1630","8308","1630","0","1948","474900"
"3","3.25","1370","1194","1370","0","2004","469000"
"2","1","1120","4284","730","390","1921","469000"
"2","2.5","1480","2167","1390","90","2007","468000"
"3","2.25","1650","7313","1220","430","1975","460000"
"2","1","880","6731","880","0","1950","454000"
"4","2.75","2090","14141","1680","410","1941","449000"
"4","2","2280","43692","1140","1140","1957","446000"
"4","2.5","1530","8375","1020","510","1974","446000"
"4","2","1540","5920","1540","0","1935","442500"
"3","2.25","1740","9682","1740","0","1969","425000"
"3","1","1160","7491","1160","0","1917","417500"
"2","1","1480","4080","1050","430","1949","410000"
"3","1","990","10752","990","0","1929","402500"
"3","1","1020","18050","1020","0","1969","399950"
"4","1.75","2020","9750","1100","920","1975","390000"
"3","2","1840","8580","1840","0","1990","380000"
"1","1.5","1200","44866","1200","0","1983","380000"
"3","1.75","1820","34800","1820","0","1967","377000"
"3","1","1440","4050","1440","0","1928","370000"
"3","2.5","3300","11525","1650","1650","1961","360500"
"4","1.75","2160","8000","1660","500","1976","355000"
"2","1","840","6720","840","0","1952","355000"
"3","1","1470","8400","1470","0","1953","352500"
"3","1","1020","4980","850","170","1941","350000"
"2","1","1350","4494","920","430","1949","345000"
"3","2.25","1250","871","1250","0","2007","344000"
"3","2.5","2420","7423","2420","0","1990","339900"
"3","2.5","1590","13440","1590","0","1992","338000"
"3","1","1050","7560","1050","0","1951","333000"
"3","1.75","1850","14986","1850","0","1943","330000"
"2","1","970","4800","970","0","1911","313300"
"2","1","1170","5150","980","190","1907","312000"
"2","1.75","1180","55321","1180","0","1941","311000"
"3","1","1120","8631","1120","0","1942","311000"
"3","1.75","1650","169448","1220","430","1977","305000"
"2","1","860","7250","860","0","1949","305000"
"4","2.25","2270","9600","1290","980","1976","304999"
"3","2","2030","17120","1890","140","1966","295450"
"3","1","960","9000","960","0","1955","290000"
"3","1.75","1550","7410","1550","0","1944","280000"
"4","1","1210","6000","1210","0","1943","279000"
"2","1","940","5000","940","0","1951","275000"
"3","1.75","2140","13068","1460","680","1974","271675"
"3","1","1500","5605","750","750","1942","270000"
"3","1.5","1320","2625","1320","0","1986","269000"
"5","4","1400","8580","900","500","1954","265000"
"3","1","1170","7395","1170","0","1969","255000"
"3","1.5","1070","5150","1070","0","1940","249000"
"3","1.75","1450","8378","1450","0","1978","230000"
"4","3","1680","6003","1150","530","1997","230000"
"3","1.75","1200","55321","1200","0","1977","213000"
"2","1","900","6400","900","0","1938","205500"
"5","1.75","1770","15525","1770","0","1959","200000"
"3","1","1320","6534","1320","0","1952","159000"
"4","3.25","4110","15929","2720","1390","2001","2300000"
"4","3.25","3460","7749","3020","440","1950","1750000"
"4","2.75","2810","8570","2810","0","1993","1570000"
"5","3.5","3220","8000","2900","320","2008","1210000"
"2","1.5","2370","184231","2370","0","2005","1060000"
"3","2","2250","8000","2250","0","1955","998800"
"4","2.5","2620","16200","1570","1050","1950","968060"
"5","3.5","4050","13495","2230","1820","1988","925000"
"4","2.5","3190","14565","3190","0","1990","870000"
"6","4.5","2750","4400","1770","980","1987","869900"
"4","2.5","3070","6923","3070","0","2009","860000"
"5","1.75","2510","6000","2010","500","1920","860000"
"4","2.75","3100","10245","3100","0","1999","792000"
"4","2.5","2240","8664","1470","770","1975","790000"
"4","2.5","2690","8036","2690","0","1987","790000"
"3","2.25","2120","9297","2120","0","1981","720000"
"4","3.5","2720","9000","2670","50","1997","709050"
"4","2.5","2650","6240","2650","0","2013","702000"
"4","2.5","2800","5368","2800","0","2003","676000"
"4","2","1890","5188","1670","220","1940","675000"
"4","3.5","3270","15704","2110","1160","1990","650000"
"3","2.5","2160","4000","1960","200","1903","640000"
"3","3","2230","1407","1850","380","2013","635000"
"3","2.5","2110","5608","1340","770","2013","604950"
"3","2.25","1580","11580","1580","0","1979","602000"
"3","1.75","1620","1325","1430","190","2005","600000"
"2","1.5","870","4800","870","0","1924","595000"
"4","2.5","3370","35150","1770","1600","1993","592500"
"2","1.5","1750","19709","1440","310","1978","575000"
"3","2.5","2060","4812","2060","0","1990","533000"
"3","1.75","1520","8835","1520","0","1957","525000"
"3","2.5","2210","70567","2210","0","1995","509950"
"4","2.75","2620","7001","2620","0","2012","499990"
"4","2.75","3010","15750","1560","1450","1973","482000"
"4","2.5","2120","57050","2120","0","1989","475000"
"3","1.75","1720","5280","900","820","1943","465000"
"3","2.5","1590","4094","1590","0","1991","454000"
"2","1","1340","8100","1340","0","1950","452000"
"2","1.75","1250","2890","790","460","1920","450000"
"3","1.75","1250","3880","750","500","1944","443725"
"3","1.5","2050","6384","1350","700","1958","442000"
"3","1.75","2000","11880","2000","0","1979","440000"
"4","2.25","2780","15075","2780","0","1985","439950"
"3","2","1700","52826","1700","0","1991","429000"
"3","1.75","2520","5043","1260","1260","1957","429000"
"3","1.75","1580","507038","1580","0","1985","428000"
"3","1","1130","9147","1130","0","1952","426000"
"3","2.25","1890","7498","1190","700","1987","423500"
"5","1.75","1960","3748","980","980","1965","415000"
"3","1.75","1510","6597","950","560","1939","410000"
"3","2.5","1509","1418","1509","0","2014","410000"
"2","1","1180","10800","1180","0","1984","400000"
"3","2.25","1740","11040","1740","0","1980","400000"
"3","2","2100","31550","2100","0","2010","399000"
"4","2","1820","7102","1220","600","1950","385000"
"2","1","880","6171","880","0","1949","378500"
"3","1","1230","9877","1230","0","1954","375000"
"3","2.5","1520","5649","1520","0","1989","375000"
"3","2.5","2120","9653","2120","0","1992","374950"
"3","1.75","1300","3844","1300","0","1985","369000"
"4","2.5","2810","10433","2810","0","2001","350000"
"4","2.5","2382","5899","2382","0","2011","345000"
"3","1.75","1260","8487","1260","0","1970","335500"
"4","2.5","2210","7214","2210","0","2003","335000"
"4","2.25","2160","8817","1460","700","1965","335000"
"2","1","1480","6210","1080","400","1950","331000"
"3","2.5","1740","1844","1320","420","2008","330000"
"2","1","1050","4800","1050","0","1969","325000"
"3","2.5","1740","5267","1740","0","1999","325000"
"2","1","750","5534","750","0","1947","325000"
"4","2.5","2050","8424","2050","0","1993","320000"
"2","2.25","1460","1607","1460","0","2007","309950"
"2","2","1520","1020","1520","0","1999","307300"
"3","2.25","1646","9519","1646","0","1994","305000"
"4","2.5","2100","6783","2100","0","2003","303000"
"3","1.75","1310","9761","1310","0","1967","300000"
"4","2","1640","7200","820","820","1944","299999"
"4","2.5","1850","6663","1850","0","1990","295000"
"4","2.5","2250","4495","2250","0","2008","292500"
"3","2","1780","11342","1780","0","1964","280000"
"2","1.75","1894","52769","1520","374","1936","280000"
"3","2","1260","22100","1260","0","1981","277500"
"5","1","1600","7350","1600","0","1962","260000"
"2","1","960","20954","960","0","1977","255000"
"4","2","1910","7826","1140","770","1973","253000"
"2","1","950","11835","950","0","1932","250000"
"2","1","750","6350","750","0","1920","250000"
"3","1","1280","9000","1280","0","1954","240000"
"3","1.75","2000","12208","1140","860","1979","237000"
"3","1.75","1320","12528","1320","0","1970","207500"
"3","1","940","7980","940","0","1960","205000"
"3","2","1670","7056","1670","0","1958","180000"
"3","1.5","1470","18459","1470","0","1916","169000"
"3","3.5","3080","6495","2530","550","1996","2160000"
"4","5.5","6550","217374","5400","1150","2006","1500000"
"4","3.5","5220","15411","3550","1670","2006","1480000"
"3","2.5","4190","9624","4190","0","1999","1150000"
"4","2.5","3110","11397","3110","0","1984","960000"
"2","1.75","3490","88909","2320","1170","1980","952000"
"4","3","3680","7105","2890","790","2008","935000"
"3","2","2010","4000","1210","800","1915","875000"
"3","2.5","2060","9715","2060","0","1924","840000"
"3","3.5","3470","4171","3470","0","2008","834800"
"3","2.5","3370","6550","2840","530","1912","830000"
"3","1.5","1290","8175","820","470","1952","781000"
"3","2.5","3220","54160","2690","530","1981","768000"
"4","2.5","3190","38119","3190","0","1988","765000"
"4","2.5","4660","7157","3020","1640","2003","760000"
"3","2.5","2110","1339","1410","700","2014","747450"
"3","1.75","2060","5721","1140","920","1964","746300"
"4","2.75","2260","12005","2260","0","1956","738950"
"4","2.75","3040","2415","3040","0","1966","735000"
"4","2.5","3070","5936","3070","0","2005","731000"
"3","1.75","1650","10250","1650","0","1963","710000"
"4","2.5","2650","9990","2650","0","1990","695000"
"3","2.5","3490","28213","2242","1248","2009","692000"
"3","2","1010","5973","1010","0","1942","675000"
"4","1.75","1440","4300","1290","150","1929","656000"
"4","2.25","2220","130244","2220","0","1989","652500"
"3","2.5","3060","7831","3060","0","2004","650000"
"3","2","2130","4000","2130","0","1908","645000"
"3","1.5","1960","4080","1960","0","1915","640000"
"3","1.75","1040","5097","800","240","1944","619790"
"3","2","1990","3000","1430","560","1927","619000"
"3","1.75","1900","5000","950","950","1951","615000"
"3","1.75","1920","7400","1260","660","1977","605000"
"3","2.5","1590","1937","1590","0","2004","580000"
"3","2.5","1740","1236","1740","0","2008","580000"
"3","1.75","1540","4800","770","770","1925","565000"
"5","1.75","1910","9720","1390","520","1955","565000"
"4","2.75","2930","22000","1580","1350","1978","560000"
"4","3","2760","13113","1760","1000","1974","550000"
"4","2.75","2360","15100","2360","0","2014","535000"
"3","2","1360","3090","1360","0","1990","532170"
"3","3.25","1510","1125","1510","0","2006","530000"
"4","2.75","2470","7200","1350","1120","1940","525000"
"4","2.5","2840","4750","2840","0","2002","525000"
"3","1","1240","4800","800","440","1951","525000"
"4","2.25","1890","8034","1890","0","1967","521000"
"3","2.25","2340","6183","1210","1130","1929","510000"
"2","1","820","5040","820","0","1953","508000"
"4","2.25","2250","3463","2250","0","1968","497000"
"3","2.5","1780","47480","1780","0","1995","495000"
"3","2","1200","2016","600","600","1931","483500"
"4","2.25","1770","7000","1770","0","1972","480000"
"4","2.5","2590","6139","2590","0","2001","479000"
"3","1.5","1750","12632","1750","0","1952","475000"
"3","3.25","1710","2381","1360","350","2003","470000"
"3","2.5","2010","2778","1390","620","2014","462608"
"3","1.75","1420","5170","1420","0","1963","461000"
"5","2.5","2650","12987","1350","1300","1979","459000"
"3","2.25","1610","5159","1610","0","1985","449950"
"4","1.75","2800","49149","1400","1400","1978","440000"
"3","1.75","1430","8400","1430","0","1961","440000"
"3","2.25","2360","14950","2360","0","1978","431000"
"3","1","1240","5750","1240","0","1948","425000"
"3","2.5","1300","877","1060","240","2008","417000"
"3","1","1350","3090","1350","0","1914","400000"
"4","2.5","2620","14258","2620","0","2014","399963"
"3","2","2130","8225","2130","0","1987","397500"
"4","2.5","1790","6590","1790","0","2005","397000"
"4","2.5","3000","8584","3000","0","2003","397000"
"2","2","1960","4018","980","980","1950","395000"
"3","2","1320","10720","1320","0","1981","393000"
"3","3.25","1600","1289","1600","0","1998","392500"
"3","2.5","1850","17808","1210","640","1982","374000"
"5","3","2670","9920","1400","1270","1990","370000"
"4","2.5","1910","10221","1910","0","1994","369950"
"3","1","1570","10050","1570","0","1963","367500"
"2","1","960","223898","960","0","1985","365000"
"3","2.25","2200","8000","2200","0","1981","360000"
"2","1","930","5077","930","0","1939","358000"
"4","2.5","2390","6775","2390","0","2003","355000"
"3","1","2010","6000","1210","800","1967","350000"
"2","1","800","5040","800","0","1960","350000"
"2","1","880","4000","780","100","1937","330000"
"2","2","1490","1627","1190","300","2009","327000"
"3","1","1780","6840","1780","0","1947","320000"
"2","1","780","8271","780","0","1924","319000"
"3","0.75","1270","10092","1270","0","1971","316000"
"2","1.75","1160","2500","1160","0","2008","310000"
"4","2","2360","7440","1180","1180","1955","300000"
"4","2","2320","12000","1720","600","1943","299000"
"4","1.5","1370","9750","1070","300","1953","296000"
"3","1","1410","5120","1210","200","1925","294350"
"4","1.75","1250","8840","910","340","1979","293550"
"4","2.5","2220","6233","2220","0","2001","291375"
"3","1.5","1520","7200","1160","360","1990","279950"
"5","1.75","2170","9752","1100","1070","1962","278000"
"3","2.5","1580","12250","1580","0","1993","267000"
"3","2.5","1680","10300","1680","0","1994","262000"
"3","1.75","1340","8000","1340","0","1980","260000"
"3","1.75","1580","7344","1580","0","1911","260000"
"4","2.75","1560","8820","1060","500","1979","259900"
"2","1","1260","7810","1260","0","1945","255000"
"3","1.5","1580","7200","1080","500","1976","249000"
"3","2","1390","8250","1390","0","1987","245000"
"3","1.75","1480","3900","1480","0","1980","245000"
"3","1","1340","7000","1340","0","1978","240000"
"3","1","2230","8163","1230","1000","1966","235000"
"2","1","1170","7142","1170","0","1951","225000"
"3","1.5","1120","8366","1120","0","1968","205000"
"3","1","1300","9600","1300","0","1975","195000"
"3","1.75","1430","10816","1430","0","1994","185000"
"3","2","1210","9097","1210","0","1954","173250"
"3","1.5","1250","7200","1250","0","1978","165000"
"3","1","1120","5000","1120","0","1917","165000"
"4","3.25","3860","17820","2630","1230","1975","2140000"
"3","2.25","3060","16000","3060","0","1988","1760000"
"2","2.5","2910","19449","1940","970","1985","1300000"
"4","2.25","4070","23321","4070","0","1968","993500"
"4","3.25","3330","33826","3330","0","1924","911100"
"4","3","3500","13444","2360","1140","1977","895000"
"5","3","2900","6730","1830","1070","1977","865000"
"4","2.5","3730","9847","3730","0","1997","840000"
"4","2.5","2320","14240","1620","700","1974","824000"
"3","2.25","2860","11250","2290","570","1956","805000"
"2","2.25","2130","5920","1830","300","1950","779000"
"3","2.5","1980","7807","1980","0","1989","775000"
"3","2.5","2730","11380","2730","0","1995","770000"
"3","2.5","2160","7525","2160","0","1986","756000"
"5","2.5","4870","11800","3470","1400","1983","722500"
"3","2.25","2110","7279","2110","0","1984","716125"
"4","2.5","2780","13521","2780","0","1987","715000"
"4","4","4000","9309","4000","0","2007","688000"
"3","2","1820","4418","1820","0","1994","661000"
"3","1.75","1960","5520","1080","880","1952","655000"
"3","2.5","2490","4904","2490","0","2003","634000"
"2","2.25","2210","5500","1410","800","1968","614306"
"3","2.5","2060","8893","2060","0","1987","610000"
"3","2.5","2320","52272","2320","0","1974","600000"
"3","2.5","1740","1279","1740","0","2008","568000"
"3","2","1640","15258","1640","0","1981","525000"
"11","3","3000","4960","2400","600","1918","520000"
"4","3","2120","5520","1420","700","1985","518500"
"4","2.75","2790","8092","2790","0","2013","505657"
"3","2","1500","2500","1500","0","2002","505000"
"4","2.5","2120","7820","1280","840","1975","490000"
"3","2.25","1280","1520","1080","200","2008","490000"
"3","1","1680","8910","1680","0","1940","489900"
"2","2.5","1470","2533","1470","0","2005","487000"
"2","1.75","1960","6000","980","980","1904","478000"
"3","1.5","1930","11092","1500","430","1983","475000"
"3","2.25","2350","51400","1390","960","1977","462500"
"2","2.5","1830","8107","930","900","1946","460000"
"3","1.75","1880","16239","880","1000","1922","452000"
"3","2.5","1639","2710","1479","160","2003","450000"
"3","1.75","2150","13789","1610","540","1966","450000"
"2","2.25","1510","7280","1510","0","1987","442500"
"2","1","1280","12086","850","430","1983","440000"
"4","2.5","1840","4593","1840","0","2010","429000"
"4","2.5","1600","14000","1310","290","1950","427000"
"3","2.5","1690","1689","1150","540","2014","419990"
"3","1","2020","19210","1760","260","1949","415000"
"3","1","1660","6992","1260","400","1952","412000"
"2","1","910","6282","910","0","1939","412000"
"4","3.5","2530","3000","1850","680","2014","382000"
"4","2.5","2680","4500","2680","0","2011","379950"
"2","1","1810","8527","1810","0","1943","375000"
"3","1.75","1830","11788","1430","400","1958","373000"
"3","2.25","1650","4859","1650","0","1988","370000"
"4","2.25","2120","9680","2120","0","1965","369160"
"4","2","1960","16015","1960","0","1980","367500"
"2","1","1240","7590","1040","200","1939","359950"
"3","2","1920","33630","1920","0","1992","352500"
"3","1.5","1360","7680","1360","0","1955","352500"
"4","1.75","2740","10086","1440","1300","1972","350000"
"4","2.25","1800","2752","1800","0","2014","338800"
"3","3.5","1500","1471","1500","0","1999","337900"
"4","1.75","1950","13440","1950","0","1931","335000"
"3","1","1300","8800","1300","0","1977","326188"
"3","1.5","1140","20383","840","300","1985","319900"
"3","2","2070","9195","1220","850","1982","310000"
"3","2","1490","7697","1490","0","1994","305000"
"3","1.75","1470","27000","1470","0","1958","299900"
"3","2.25","2540","9961","1320","1220","1969","299000"
"4","2.5","1860","6325","1860","0","1991","291000"
"3","2.5","2070","5013","2070","0","1987","289950"
"4","2.5","2360","7350","1440","920","1965","285000"
"5","1.75","2180","9178","1140","1040","1963","275000"
"3","1.75","1995","18360","1995","0","1957","271500"
"3","1.5","1820","10608","1820","0","1962","264000"
"2","1","750","4515","750","0","1942","263500"
"3","1","1480","7469","1120","360","1940","260000"
"3","1.75","1260","1133","810","450","2011","255000"
"3","2","1490","7929","1490","0","1989","245000"
"3","1","1470","32670","1020","450","1958","238000"
"3","2","1200","6074","1200","0","1968","222000"
"3","1.75","1400","7300","1400","0","1948","210000"
"2","1","1440","6650","970","470","1980","203000"
"2","1","930","11450","930","0","1946","190000"
"2","1","1230","5000","1230","0","1911","184900"
"3","1","840","5700","840","0","1945","180000"
"2","1","930","3447","930","0","1978","178500"
"4","3.5","5990","111078","5990","0","2004","1530000"
"5","6","6880","279968","4070","2810","2007","1490000"
"4","2.25","3780","5160","2510","1270","1907","1400000"
"3","2.25","2930","6000","1920","1010","2000","1390000"
"3","3.5","4310","5432","3140","1170","1988","1200000"
"3","3.25","3710","38509","3710","0","1998","935000"
"3","1.75","2120","56192","1720","400","1959","892500"
"4","2.75","3410","23000","3410","0","1982","870000"
"5","2.75","1990","3750","1990","0","1913","852000"
"4","2.75","3660","5637","3660","0","2014","839990"
"5","2.75","3010","4919","3010","0","2014","831548"
"3","2.5","2040","4559","2040","0","1998","812000"
"5","2.75","3847","17654","2299","1548","1975","810000"
"5","2","2880","12000","2880","0","1921","780000"
"4","3.25","3140","3680","2310","830","2009","760000"
"3","2.5","2420","9000","2420","0","1987","752888"
"2","2.25","1890","5400","1610","280","1905","750000"
"3","2","2230","9870","1290","940","1915","736500"
"4","1.75","1930","3876","1450","480","1924","733000"
"4","2.5","2760","6440","2760","0","1999","686000"
"3","2.25","2730","10675","2730","0","1990","678000"
"3","1.75","2020","9718","2020","0","1956","677500"
"2","1.5","1750","46173","1750","0","1964","661000"
"4","2.5","2320","11259","2320","0","1982","640000"
"4","3.25","2690","7200","1720","970","1978","635000"
"2","1","1100","4160","1100","0","1919","625000"
"4","2.5","3190","27806","3190","0","1997","625000"
"3","1.75","2240","6050","1250","990","1950","625000"
"5","3.5","3240","6919","2760","480","2014","612995"
"4","2.5","2100","8800","1250","850","1980","610000"
"3","2.5","4930","77536","3930","1000","1981","600000"
"4","2.5","2370","9135","1600","770","1967","600000"
"4","2.5","2600","6536","2600","0","1999","600000"
"2","1.75","1550","7764","1550","0","1965","600000"
"4","2.5","2640","6738","2640","0","1989","599000"
"4","1.75","1930","7245","1510","420","1972","588000"
"5","2","2560","14467","1280","1280","1960","585000"
"3","1.75","1930","10183","1480","450","1975","583000"
"3","2","2730","15677","2730","0","1976","565000"
"3","2.5","1650","5683","1650","0","2003","500000"
"2","2","1540","7110","960","580","1949","495000"
"3","2.25","2230","13100","1510","720","1974","491500"
"4","1","2590","18224","2000","590","1911","470000"
"2","1","1250","5650","1250","0","1943","463000"
"3","2","1320","4000","1020","300","1940","462600"
"2","1.5","910","966","820","90","2006","455000"
"3","1.75","2040","15695","2040","0","1959","452500"
"4","2.5","2070","7312","1230","840","1977","449950"
"3","2.5","1810","1658","1810","0","1998","449000"
"4","2.5","2790","8111","2480","310","2004","445000"
"3","2.5","1430","1056","1430","0","2003","443600"
"2","1.5","1210","1232","1210","0","2007","437500"
"4","2","1600","15044","1600","0","1972","436000"
"4","3.25","3310","8897","2380","930","1991","429900"
"4","2.5","2270","4400","2270","0","2006","425000"
"3","2","2080","12094","2080","0","1982","424240"
"2","2.5","1470","2034","1470","0","1985","419000"
"3","1","1000","3844","900","100","1928","412000"
"2","1.75","1250","7680","1250","0","1922","400000"
"3","3","2090","7634","1450","640","2001","400000"
"4","2.5","3200","7545","3200","0","2003","399950"
"3","1.75","1740","6220","1740","0","1954","395000"
"3","2.5","1370","4400","1370","0","1988","394000"
"3","2.25","2110","8000","2110","0","1975","385000"
"3","1","1380","5400","1380","0","1954","380000"
"3","1.5","1240","7733","790","450","1941","375000"
"4","2","2070","9822","2070","0","1955","375000"
"2","1.5","1110","1189","1110","0","2000","371000"
"4","2","1770","8890","1770","0","1949","355000"
"3","1.75","1780","9689","1130","650","1976","354950"
"3","1","1200","6628","1200","0","1952","345000"
"4","2","1910","10200","1910","0","1963","335000"
"3","1","890","5965","890","0","1950","328000"
"2","1","900","8374","900","0","1984","325000"
"1","1","1220","12426","1220","0","1946","325000"
"4","2.5","2641","8615","2641","0","1998","324950"
"3","1","1010","7500","1010","0","1975","315000"
"3","2.5","1590","3359","1590","0","2000","310000"
"4","2.5","2010","12085","2010","0","1986","299500"
"3","2","2110","6900","1220","890","1955","285000"
"3","2.25","1940","9560","1940","0","1989","283748"
"3","2.25","1260","915","1020","240","2007","282000"
"3","1","1280","12928","1280","0","1942","279900"
"4","2.75","2060","7350","1210","850","1978","275000"
"3","2.25","1660","7003","1660","0","1996","269950"
"4","1","1610","8401","1610","0","1958","269000"
"3","1","940","4700","940","0","1942","267000"
"3","2","1320","8959","1320","0","1993","265000"
"3","2.5","1640","7668","1640","0","1991","265000"
"4","2.5","1990","9656","1990","0","1994","264950"
"3","2.25","1570","8410","1180","390","1991","252000"
"3","2.25","1960","7414","1490","470","1984","250000"
"3","1","1640","26127","1640","0","1975","250000"
"2","1","1130","15190","1130","0","1954","239000"
"2","1","1010","7500","1010","0","1941","235000"
"3","1","970","5000","970","0","1968","226000"
"3","1.5","1440","8370","1440","0","1977","224000"
"4","1.75","1660","11664","1010","650","1952","220000"
"3","2","1800","11419","1800","0","1989","205000"
"2","1","770","2500","770","0","1913","203700"
"2","1","930","8665","930","0","1938","200000"
"2","1","820","16030","820","0","1923","185000"
"3","2.5","1660","2415","1660","0","1983","165000"
"4","2.25","2860","5658","2130","730","1933","1300000"
"4","2.5","2650","13684","2650","0","1994","728000"
"4","3","2190","12825","1520","670","1989","625000"
"3","1.75","1670","9900","1670","0","1957","620000"
"3","3","2330","4284","1920","410","2004","453000"
"4","2.5","2245","4301","2245","0","2014","362865"
"2","2","1340","7605","1340","0","1992","230000"
"3","1.75","1760","3520","1160","600","1966","410000"
"4","2.5","1820","9161","1220","600","1975","325000"
"3","3","3920","13085","3920","0","1996","3100000"
"3","2","3570","30456","2070","1500","1946","2200000"
"4","4","4920","50621","4280","640","2012","1410000"
"5","2.75","2410","19447","2290","120","1968","1320000"
"4","4","4320","8709","3190","1130","2006","1050000"
"4","3.25","3320","8587","2950","370","2008","1000000"
"5","3","3350","9450","2180","1170","1912","1000000"
"4","1.5","3120","7680","1660","1460","1956","976000"
"4","2.5","3780","23623","3780","0","1997","962800"
"3","2.5","3140","9808","2500","640","2001","915000"
"3","2.25","2180","9865","1660","520","1966","910000"
"3","2.5","2850","11535","1680","1170","1952","900000"
"3","2","2520","3959","1270","1250","1931","861000"
"5","3.5","3150","4120","2460","690","1911","850000"
"4","2.75","4010","87555","4010","0","2004","849000"
"4","2.5","2120","10841","1500","620","1979","828000"
"4","2.5","3170","3862","3170","0","2008","820000"
"4","2.5","2840","8820","1420","1420","1952","814000"
"2","2.5","2510","17986","2510","0","1943","811000"
"4","1.5","2220","4000","1970","250","1925","785000"
"3","1.75","1640","18730","1640","0","1946","775000"
"4","2.25","2360","8616","2360","0","1974","752500"
"4","2.75","3280","6845","3280","0","2003","734500"
"4","3","3150","9703","3150","0","2001","727000"
"3","1.75","2430","11448","1620","810","1949","710000"
"4","2.5","2630","8580","1700","930","1977","710000"
"3","3","2260","1825","1660","600","2002","660000"
"3","2.5","2560","43608","2560","0","2002","619000"
"4","2","2140","6360","1840","300","1945","615750"
"2","1","1390","5562","1010","380","1913","608000"
"3","2.5","2960","18600","2960","0","1979","605000"
"4","2.5","2030","9825","1330","700","1985","598000"
"4","2","2120","4000","1720","400","1927","597000"
"5","2","3930","10150","3070","860","1968","589000"
"3","1.5","1670","5000","1670","0","1912","585000"
"4","3.5","1460","951","1460","0","2008","580000"
"4","1","1350","4000","1350","0","1930","571000"
"3","2","1830","3500","1290","540","1909","554000"
"3","1.75","1380","3561","860","520","1925","535000"
"5","1.75","2120","8625","1200","920","1959","534000"
"4","2.5","2690","46609","2690","0","1980","530000"
"3","2.5","2480","7480","2480","0","1992","530000"
"4","2","1720","6099","860","860","1949","525000"
"3","1.75","1750","2983","1230","520","1929","524950"
"2","2","1600","5969","800","800","1950","523500"
"3","2.25","1920","11500","1920","0","1972","515000"
"3","2.25","1500","1312","1500","0","2007","513000"
"3","2.5","2270","5536","2270","0","2003","507250"
"2","1","960","5000","960","0","1900","500000"
"4","2.25","1960","12436","1960","0","1984","500000"
"2","2.5","1320","1157","990","330","2014","499000"
"3","2.5","2100","5060","2100","0","2006","477000"
"3","1.5","1740","9038","1740","0","1955","472000"
"4","2.75","2190","990","2190","0","2004","465000"
"3","1.75","1440","7070","1440","0","1980","460000"
"2","1.5","1170","1079","1170","0","2003","459500"
"3","2","1430","9583","1430","0","1964","453000"
"4","1.5","1620","5444","1620","0","1955","451000"
"3","1.75","1360","5445","1360","0","1957","450000"
"4","2.5","2300","10880","1190","1110","1961","440000"
"2","1.75","1210","3000","910","300","1906","439950"
"3","2","1490","3072","770","720","1912","438500"
"3","2.25","1570","7475","1200","370","1983","425000"
"3","1.75","1580","6127","1580","0","1947","402000"
"4","2.5","2650","9451","2650","0","1993","397450"
"3","1","1090","6125","790","300","1945","392000"
"2","1","1120","7560","1120","0","1947","380000"
"1","1","950","10585","950","0","1929","377000"
"3","1.5","1330","10640","1330","0","1976","374000"
"4","3","2130","4838","2130","0","1930","370000"
"3","2.75","2120","7650","2120","0","1958","370000"
"3","2.5","2313","5700","2313","0","2011","370000"
"4","2.5","1800","5070","1080","720","1979","365000"
"4","1.75","3730","16980","2150","1580","1974","360000"
"2","2","1180","3200","590","590","1945","360000"
"3","1","1150","4681","1150","0","1955","358000"
"4","2","2060","13400","2060","0","1957","350000"
"4","2.5","2000","5006","2000","0","2005","349950"
"3","2.5","2140","7715","2140","0","1991","349950"
"3","1.75","1260","7128","1260","0","1969","349500"
"4","2.5","2370","10631","2370","0","1999","338000"
"3","2","2440","23512","1640","800","1933","338000"
"4","2.5","2370","6000","2370","0","2001","335000"
"4","2.25","2430","7490","2430","0","1983","330000"
"4","2.5","2510","8580","2510","0","1991","330000"
"3","1","1130","7200","1130","0","1942","316000"
"4","2.5","2280","3800","2280","0","2006","305000"
"3","2.5","1750","4200","1750","0","2005","300000"
"2","1","860","8189","860","0","1948","298800"
"3","1.75","1500","15246","1500","0","1925","295000"
"3","2.25","1500","7308","1210","290","1968","290000"
"3","1.5","1310","8100","1310","0","1965","290000"
"2","1.5","1020","1275","1020","0","2008","290000"
"3","2.25","2200","8375","2200","0","1988","285167"
"4","1.5","1930","15000","1930","0","1946","270000"
"3","1.75","1480","8009","980","500","1980","268000"
"1","1","800","2480","800","0","1919","267000"
"4","2","1540","10212","1540","0","1948","259950"
"4","2.5","2600","11280","1570","1030","1961","252500"
"3","1.5","1800","9216","1800","0","1950","237000"
"3","1.5","1380","7600","790","590","1971","235500"
"3","1","1210","6000","1210","0","1930","235000"
"3","1.75","1900","8910","1900","0","1988","229950"
"3","2.5","1750","7490","1180","570","1979","225000"
"3","1","1220","6000","1220","0","1968","213500"
"3","1","1000","12070","1000","0","1968","204000"
"3","1.5","1190","8726","1190","0","1956","195000"
"3","1.5","1630","22764","1630","0","1970","165000"
"1","0.75","480","9750","480","0","1948","145000"
"4","4","4810","18851","4810","0","2007","3200000"
"3","2.75","3050","9050","2330","720","1968","2000000"
"4","3","3600","9687","3600","0","1959","1700000"
"4","3.25","3820","8114","3820","0","2005","1620000"
"4","3.75","3880","9979","3880","0","2007","1060000"
"4","3","3560","4000","2970","590","1996","1050000"
"5","4.5","4130","10404","4130","0","2004","998000"
"4","2.75","3140","7258","3140","0","2006","920000"
"3","2.5","2040","6000","1840","200","1951","872500"
"4","2.5","3370","9629","3370","0","1999","806000"
"4","2.5","3160","35225","2250","910","1992","805000"
"4","2","2130","2800","1070","1060","1922","800000"
"4","2.25","2580","21115","2580","0","1977","787888"
"3","1.75","2320","6400","1420","900","1957","779000"
"4","2.5","3150","5979","3150","0","2005","762500"
"4","2.5","2730","10753","2730","0","1991","756000"
"4","2","1960","4520","960","1000","1922","745000"
"6","2.25","3140","10250","1570","1570","1959","740000"
"3","3.25","2960","39370","2960","0","1989","735000"
"4","3.5","3490","87497","3490","0","2001","728000"
"3","2","2880","5100","2080","800","1926","660000"
"5","2.5","2530","10190","1290","1240","1960","657000"
"3","2.5","2790","6720","2790","0","2002","650000"
"4","3.5","3080","118918","3080","0","2008","637000"
"3","1","1360","13000","1360","0","1945","630000"
"3","2","1940","3800","1050","890","1927","627000"
"4","2.75","3470","212639","2070","1400","1993","598600"
"3","2","1530","6773","1530","0","1984","595000"
"3","2.5","1750","4797","1750","0","1991","575000"
"4","2.5","3230","5899","3230","0","2012","569950"
"3","2.5","1940","3211","1940","0","2009","555000"
"5","1","2150","262231","2150","0","1900","550000"
"4","2.5","2470","5954","2470","0","2013","550000"
"3","2","1560","5130","1150","410","1915","549000"
"3","2","2040","5600","1120","920","1954","535000"
"3","2.5","2340","35021","2340","0","1986","525000"
"4","2.5","2900","4950","2900","0","2004","520000"
"4","2.5","2320","4000","1510","810","1905","518000"
"4","2.5","2890","15067","2890","0","2003","515000"
"2","2.25","1570","1269","1280","290","2015","500000"
"4","2.25","2350","7210","2350","0","1972","500000"
"4","2.5","2040","6685","2040","0","1998","500000"
"2","1.75","1810","4220","1810","0","2004","489000"
"2","1","1030","3060","790","240","1918","480000"
"4","2.25","2520","2370","1690","830","1908","480000"
"5","2.5","2080","8347","1460","620","1975","474950"
"4","2.75","2150","9820","1220","930","1979","470000"
"4","2","1560","3840","960","600","1924","459000"
"2","1","910","5000","910","0","1914","450000"
"3","1.75","1300","4800","1300","0","1912","448500"
"3","2.75","2180","3703","2180","0","2004","445000"
"4","1","1780","4000","1780","0","1922","440000"
"4","3","2010","8171","2010","0","1973","434000"
"2","2","1390","12530","970","420","1959","431000"
"4","1.75","1710","7724","1710","0","1983","430000"
"3","1.5","1550","5034","1550","0","1922","430000"
"4","2.5","2750","7200","2750","0","2011","430000"
"2","1","1430","13300","1230","200","1921","425000"
"3","1.5","1390","9680","1390","0","1956","425000"
"2","1","820","4025","820","0","1922","420000"
"4","2.5","2480","8626","2480","0","2001","420000"
"3","2.25","2020","21010","2020","0","1995","420000"
"3","2.5","1570","4926","1570","0","2014","417000"
"3","1.5","1260","9570","870","390","1941","414900"
"4","2.5","3490","9030","3490","0","1969","414000"
"3","2","1740","9300","1740","0","1952","410000"
"3","2.5","1509","1114","1509","0","2014","401500"
"3","1.75","1330","9143","1330","0","1960","400000"
"3","1.75","1730","9211","1730","0","1961","400000"
"3","1","1470","7930","1070","400","1950","399950"
"3","3","2240","10479","1710","530","1950","399000"
"2","2.5","1860","3504","1860","0","2000","380000"
"2","1.5","1010","2102","1010","0","1984","370000"
"3","2.5","2850","12593","2850","0","1997","364988"
"4","1.75","1850","5712","1850","0","1954","352000"
"2","1.5","2060","10880","1190","870","1924","348140"
"3","3.25","1600","1882","1360","240","2000","345000"
"5","2","2130","8412","1440","690","1946","344000"
"4","2.5","2520","7205","2520","0","1987","335000"
"3","1","1590","12040","1090","500","1954","325000"
"3","2","1820","17600","1820","0","1972","320000"
"3","2.25","1358","1204","1358","0","2007","317000"
"3","1.75","1870","8400","990","880","1977","315500"
"3","2.5","2370","6752","2370","0","1994","310000"
"5","2.25","1980","13132","1260","720","1962","307700"
"3","2","1390","5127","1390","0","1990","297950"
"3","1.75","1550","4057","830","720","1945","294010"
"3","1","1010","10800","1010","0","1972","290000"
"3","2.5","2110","8304","2110","0","1985","289000"
"3","2.5","1610","6000","1610","0","1993","282000"
"3","2.25","1760","8287","1160","600","1986","270000"
"3","2","1640","8395","1640","0","1991","269500"
"3","2.5","1700","2250","1700","0","2014","268000"
"3","1.75","1420","8250","1420","0","1954","265000"
"4","2.25","2300","9100","1280","1020","1977","265000"
"3","1.75","1630","5999","1630","0","1985","265000"
"3","1","1790","11884","1790","0","1951","260000"
"3","2","1300","9334","1300","0","1981","257500"
"2","1","1610","19965","1610","0","1952","255000"
"4","2","2180","8800","1170","1010","1977","254950"
"2","1","910","6000","910","0","1943","254000"
"3","2.25","1740","10836","910","830","1981","252000"
"3","2","1300","8400","1300","0","1967","251000"
"3","2.25","1560","15340","1560","0","1997","250000"
"3","2.5","2070","8400","2070","0","1990","250000"
"3","1.75","1520","9600","1520","0","1966","240000"
"2","1","820","5100","820","0","1954","235000"
"2","1","910","7617","910","0","1936","235000"
"2","1","2150","4500","1260","890","1917","235000"
"3","1","880","7500","880","0","1978","230000"
"2","1","860","9000","860","0","1942","216000"
"4","1.75","1250","12705","1250","0","1971","212000"
"3","1","1080","10200","1080","0","1962","207000"
"3","1","1370","10708","1370","0","1969","205000"
"2","0.75","1130","11429","1130","0","1956","204950"
"2","1","600","4854","600","0","1922","174000"
"1","1","610","4400","610","0","1922","126000"
"4","3.5","4285","9567","3485","800","1946","1650000"
"4","3","3050","6179","2330","720","1926","1480000"
"4","3.75","3830","41263","3830","0","1990","1250000"
"4","3.5","4560","16643","2230","2330","1995","1200000"
"4","3","3410","6541","2680","730","2007","1090000"
"4","3.5","4210","6481","3260","950","2014","1050000"
"3","2.5","3400","5119","2300","1100","2014","1050000"
"4","3.75","4133","361548","4133","0","2000","979500"
"3","2.5","2830","3750","2830","0","2014","969950"
"5","3.25","3250","14342","3250","0","1968","951000"
"3","2","2250","2975","1880","370","1905","950000"
"3","2.5","3080","8448","3080","0","2000","950000"
"4","3.5","3510","11200","3510","0","2001","935000"
"4","3.5","2980","3000","2340","640","2008","905000"
"5","3","4350","37169","2950","1400","1972","900000"
"2","1","1150","12775","1150","0","1908","825000"
"3","2.5","2550","6240","1750","800","1957","808000"
"4","2.75","3640","231739","3640","0","1999","780000"
"2","2.5","2170","6750","2170","0","2012","765000"
"4","1.75","2530","5000","2070","460","1917","720000"
"4","2.25","2480","9780","1900","580","1975","716000"
"3","2.5","2740","18455","1510","1230","1977","699000"
"3","2.5","2680","5497","2680","0","2001","699000"
"2","1.75","1570","1207","1570","0","2007","695000"
"3","2.25","2430","8327","1430","1000","1978","690000"
"2","1.5","1995","115670","1995","0","1991","645000"
"3","2.5","2220","2550","2220","0","1990","641250"
"4","1.75","2020","16120","2020","0","1969","640000"
"5","2.5","2260","10087","1520","740","1967","632000"
"3","2.5","2330","3141","2330","0","2003","625000"
"3","2.5","2260","4550","1380","880","1928","622500"
"4","2.5","2120","3640","2120","0","2005","599000"
"3","2.5","2400","81892","2400","0","1985","592000"
"3","2.75","2200","3885","2200","0","2002","572000"
"4","2.5","2280","4602","2280","0","2003","565000"
"4","2","2560","9390","1280","1280","1957","552625"
"5","3.75","3090","4943","3090","0","2010","551000"
"4","2.25","2390","40510","2390","0","1969","545000"
"5","2.5","3100","10189","3100","0","2002","540000"
"4","2","1560","7104","1140","420","1945","537000"
"4","2.5","2710","12138","1700","1010","1968","535000"
"4","2.75","2210","10800","1170","1040","1997","516000"
"3","2.25","1640","8400","1640","0","1962","515000"
"4","2","2100","12620","2100","0","1972","500000"
"3","1.75","2130","6360","1720","410","1959","495500"
"3","2.25","2100","7335","2100","0","1983","492000"
"3","2.25","2550","8588","2550","0","1989","490000"
"3","2.5","2120","4512","2120","0","1988","475226"
"5","1.75","2030","12342","2030","0","1942","470000"
"4","2","2180","17180","2180","0","1977","470000"
"4","2.5","3030","47958","1660","1370","1980","465000"
"4","1.75","2100","50965","1280","820","1959","457000"
"4","3","1890","13140","1270","620","1967","450000"
"4","3","2800","6977","2800","0","2003","449950"
"4","2.5","2170","6000","1630","540","2008","445000"
"4","1.75","1620","8132","1620","0","1974","442200"
"2","1","1120","88327","1120","0","1972","435000"
"3","2","1720","128066","1720","0","1994","427000"
"3","2","2330","6346","1600","730","1934","420000"
"3","2","1250","1306","1250","0","2001","418000"
"3","1","1220","7771","1220","0","1963","405000"
"3","3.25","1770","1977","1770","0","2001","401000"
"3","2.25","1350","944","1050","300","2007","388500"
"3","2.5","2370","4200","2370","0","2014","387865"
"4","2.5","2270","11500","1540","730","1967","380000"
"1","1","1090","5250","980","110","1927","375000"
"4","2.25","2330","11400","2330","0","1974","375000"
"3","1.75","1150","6600","1150","0","1970","370000"
"3","2.5","2200","9696","2200","0","1987","365000"
"3","2.25","2430","7614","1900","530","1979","365000"
"4","2.5","2800","6820","2800","0","1997","365000"
"3","2.5","2280","10800","2280","0","1994","364250"
"3","3","1850","9600","1230","620","1981","355000"
"3","1.75","2040","8173","1470","570","1958","355000"
"3","1.75","1360","18123","1360","0","1983","350000"
"4","2","1570","11200","1120","450","1959","342000"
"3","1.75","1540","10400","1540","0","1977","340000"
"4","1","1360","5900","1360","0","1949","329950"
"3","2.5","1780","7859","1780","0","1988","309000"
"3","2.5","1590","3381","1590","0","2000","300000"
"3","1","1300","20812","1300","0","1927","300000"
"3","1.75","1430","4850","930","500","1978","284000"
"3","1","860","7632","860","0","1920","278000"
"3","1","1140","8144","1140","0","1956","277000"
"3","2.25","2160","9612","2160","0","1994","277000"
"3","1.75","1300","20700","1300","0","1962","275000"
"3","1.75","1260","7500","840","420","1947","270000"
"3","2.25","1140","977","850","290","2008","268500"
"3","2.75","1880","1793","1810","70","2001","268000"
"5","2.25","2600","8075","2600","0","1969","265000"
"3","1","1250","21303","1250","0","1970","259875"
"3","1","1240","5700","1240","0","1953","238000"
"2","1","880","5600","880","0","1955","235000"
"4","2.5","1820","8217","1120","700","1987","234000"
"3","1.75","1260","10164","1260","0","1964","230000"
"3","2","1320","5665","1320","0","1986","225000"
"4","1","1410","7000","1410","0","1963","225000"
"3","1.5","1060","9225","1060","0","1955","212000"
"4","2","1710","8288","1710","0","1970","211000"
"3","1","1730","7210","1430","300","1963","210000"
"3","1.75","1490","8000","1200","290","1978","203000"
"4","1","1470","6061","1470","0","1945","150550"
"5","3.5","4330","11979","2090","2240","2008","3170000"
"5","4.5","6085","142725","6085","0","2000","1610000"
"2","2.5","2720","16637","2160","560","1953","1440000"
"6","5.25","6160","27490","4040","2120","2007","1280000"
"4","3.25","3850","19842","3180","670","1989","1200000"
"3","2.5","2550","5100","2550","0","2014","1100000"
"2","2.25","3900","14864","1950","1950","1947","1070000"
"2","2","1600","64468","1600","0","1950","995000"
"5","3.25","4130","7197","4130","0","2012","995000"
"4","2.5","2950","7024","2950","0","2012","921800"
"5","2.5","2750","5589","1840","910","1910","915000"
"4","2.5","3400","35062","3400","0","1988","915000"
"3","2.75","3240","7200","1620","1620","1960","902000"
"3","2.5","3530","5414","3530","0","1997","898000"
"4","2.5","4090","11225","4090","0","2005","885000"
"4","3.75","3610","7904","3290","320","1994","830005"
"2","2.5","2170","8678","2170","0","2008","740000"
"3","2","1780","9732","1780","0","1967","710000"
"2","2.5","2130","5001","1330","800","1972","707000"
"2","2.5","2380","6600","2380","0","2010","699800"
"4","2.5","3030","30000","3030","0","1981","682000"
"5","2.5","2960","8968","1640","1320","1965","654000"
"3","1","1300","8266","1300","0","1953","650000"
"3","2.5","2790","31798","1650","1140","1953","640000"
"4","2.5","2840","6284","2840","0","2013","636230"
"3","2.5","2000","6341","1040","960","1981","625000"
"2","1.75","1620","4879","1040","580","1924","577000"
"4","2.75","2990","4521","2990","0","2014","564950"
"3","1.75","1650","3200","1650","0","1901","550000"
"4","2.25","2170","10000","1420","750","1975","546800"
"4","1.75","1940","8990","1560","380","1956","545000"
"3","1.75","1410","4080","1410","0","1927","541000"
"3","2","1770","7200","1770","0","1967","514000"
"3","2.25","2210","11585","1510","700","1958","507000"
"4","2","2730","12000","1410","1320","1998","505000"
"4","2.5","2430","42646","1450","980","1989","490000"
"3","2.25","1620","1062","1620","0","2014","490000"
"3","1.75","1870","25157","1870","0","1978","475000"
"3","2","1870","8442","1060","810","1927","456000"
"4","2.75","3030","117378","1680","1350","1959","455000"
"3","1.75","1540","61419","1540","0","1967","450000"
"3","1.75","1570","8400","1570","0","1959","439995"
"3","1.75","1250","7030","1250","0","1965","439000"
"3","3","1520","1884","1520","0","2009","399000"
"2","2","1170","8251","1170","0","1941","393820"
"2","1","1270","8164","1270","0","1941","390000"
"3","1.75","1400","10018","1400","0","1962","389000"
"5","2.5","2760","11340","2760","0","1978","380000"
"5","1.5","2050","9360","1520","530","1968","375000"
"3","2.5","2490","4244","2490","0","2005","370000"
"4","1","1540","9541","1540","0","1961","370000"
"3","1.75","1830","10000","1830","0","1913","360000"
"5","2.5","2990","9240","2990","0","2015","357000"
"3","1.75","1720","10710","860","860","1957","340000"
"5","2.75","2166","6342","2166","0","2013","326000"
"3","2.5","1980","4500","1980","0","2012","317750"
"4","1.75","2080","8750","1330","750","1967","300000"
"3","1.75","1810","34500","1230","580","1980","299500"
"4","3","2120","7650","2120","0","1964","295000"
"3","1.75","1260","8400","1260","0","1954","289000"
"2","1","610","4000","610","0","1918","286000"
"3","1.75","1020","5000","1020","0","1954","285000"
"2","1","1000","10320","1000","0","1943","270000"
"3","2.5","1870","5000","1870","0","2009","270000"
"4","2.5","1820","5000","1820","0","2004","265000"
"3","1.5","1300","7885","1300","0","1968","263000"
"3","2","1610","14046","1610","0","1933","259000"
"3","2.25","1730","9516","1180","550","1978","257000"
"3","1.5","1490","6604","1490","0","1918","255000"
"3","1.5","1180","7384","1180","0","1959","250200"
"3","2.5","1650","2802","1650","0","2004","250000"
"2","2","1360","3300","1360","0","2004","222000"
"4","1.5","1430","8775","1030","400","1979","215000"
"2","1","1000","4500","1000","0","1916","207100"
"4","1","1220","11730","1220","0","1960","199000"
"3","1","1010","9920","1010","0","1977","179900"
"2","1","670","5000","670","0","1948","107000"
"3","1.5","910","5120","910","0","1973","107000"
"4","3.5","4860","23885","4860","0","1996","2950000"
"4","2.25","2920","20400","2920","0","1966","1650000"
"4","2.5","4070","7800","3390","680","2002","1400000"
"4","3.5","4190","15724","4190","0","1994","1160000"
"3","1.75","2170","12220","2170","0","1965","907000"
"3","2","2870","6360","1790","1080","1946","810000"
"3","2.5","2760","9471","1760","1000","1956","800000"
"6","2.5","3250","12000","1800","1450","1966","779000"
"4","2.75","3630","15405","1850","1780","1968","769000"
"3","2.5","2270","9822","2270","0","1988","766000"
"4","2.5","2460","4425","2460","0","2006","693000"
"5","2.25","2120","4000","1720","400","1910","682000"
"5","3","4180","8561","4180","0","2003","673200"
"4","2.5","2470","77550","2470","0","1987","635000"
"3","1.75","2170","153767","2170","0","1976","585000"
"3","3","1850","12556","1850","0","1976","565000"
"2","2","1370","1878","1370","0","2004","548000"
"4","2.5","2080","8504","2080","0","1991","545000"
"4","2.75","2790","6685","2790","0","2014","533380"
"4","2.5","2770","21806","2770","0","1991","533300"
"3","1.5","1580","3172","900","680","1946","524500"
"3","1.75","1690","53578","1690","0","1984","509900"
"2","1","1020","5000","1020","0","1916","505000"
"3","1","1160","4360","1160","0","1929","501000"
"3","1.75","2110","10454","1440","670","1978","483000"
"3","1.5","2100","67269","1220","880","1949","480000"
"2","1","870","7975","870","0","1946","475000"
"4","2.5","3361","5038","3361","0","2014","471275"
"2","2.25","1210","1267","1120","90","2010","461100"
"2","1","1220","6000","880","340","1938","452000"
"3","1","1200","4000","1200","0","1923","438000"
"3","2","1520","11067","1140","380","1983","434900"
"3","2.25","1700","7650","1340","360","1975","419000"
"4","2.25","2240","12650","1730","510","1981","415000"
"3","1.5","1860","9003","1490","370","1955","415000"
"3","2.5","1890","6500","1890","0","2012","409000"
"4","2.5","2030","9095","1130","900","1972","405000"
"3","2.5","1520","3425","1520","0","1986","402000"
"4","2.5","2398","5988","2398","0","2008","400000"
"3","1.75","1920","8775","1920","0","1953","380000"
"3","2","1860","9100","1860","0","1939","370000"
"3","2.25","1445","1028","1300","145","2005","366000"
"2","1","990","8250","990","0","1955","365000"
"3","1.75","1410","9150","1410","0","1959","365000"
"5","2.5","2990","7292","2990","0","1990","339950"
"3","1.75","1560","7500","1560","0","1966","306000"
"4","2.5","2340","52272","2340","0","1978","290000"
"3","1.75","1490","8000","1490","0","1978","275000"
"3","2.25","1830","7651","1830","0","1986","273000"
"3","1.5","1370","10115","1370","0","1957","264950"
"3","2","2710","5000","2710","0","1951","260000"
"3","1.75","1670","8511","1340","330","1985","260000"
"3","1.75","1540","8885","1440","100","1980","244000"
"1","1","530","6350","530","0","1941","238000"
"3","1","1030","7800","1030","0","1954","229000"
"4","1.75","1630","8000","1630","0","1959","215000"
"3","1.75","1260","10488","1110","150","1952","194000"
"3","1","1040","4480","870","170","1924","642000"
"5","3.25","4100","7578","4100","0","2011","890000"
"5","1.75","1320","38125","1120","200","1947","380000"
"4","2.5","1950","8628","1950","0","1994","348450"
"3","2","3010","5000","1890","1120","1931","1100000"
"3","2.25","2580","11060","2580","0","1964","898000"
"4","2.5","1840","4011","1840","0","2005","583000"
"3","2.25","1780","9969","1450","330","1985","450000"
"3","1.5","1050","4590","850","200","1949","438924"
"3","2.25","1740","9370","1390","350","1992","289950"
"4","3.25","3890","25470","3030","860","1923","2950000"
"4","5","5810","7440","3790","2020","2004","1880000"
"4","3.75","4410","9231","4410","0","2001","1440000"
"4","2","2850","14810","2490","360","1954","993000"
"3","1.5","1250","8710","1250","0","1953","888000"
"4","2.25","2410","4000","1650","760","1910","883000"
"4","2","2380","10800","2380","0","1925","855000"
"4","3.25","4110","14219","2570","1540","1979","825000"
"4","3.5","3290","8059","3290","0","2012","801000"
"3","3.5","3190","10223","2560","630","1994","795000"
"2","2.5","2390","6928","1810","580","1949","787500"
"5","2.75","3890","9130","3890","0","2004","772500"
"3","1","1640","6516","1440","200","1935","750000"
"3","1.75","1590","8285","1590","0","1956","750000"
"4","2.75","2490","3840","1610","880","1922","749500"
"5","3.5","2790","16952","1970","820","1991","738000"
"4","2.5","3290","5951","3290","0","2003","728000"
"3","2.5","2980","16996","2980","0","1992","725000"
"3","2","1880","3000","1040","840","1931","710000"
"3","1","1750","5355","1750","0","1929","707900"
"4","3.5","3150","6175","3150","0","2001","700000"
"4","3","3150","6175","3150","0","2001","680000"
"4","3","2900","15535","1870","1030","1961","650000"
"4","2.25","2720","18295","2000","720","1979","645000"
"3","2.5","1770","3744","1270","500","1929","643002"
"3","2.25","2680","175982","2680","0","2004","635000"
"3","3.5","1730","1349","1350","380","2009","635000"
"4","2.75","2090","8400","1240","850","1976","610000"
"4","2.5","2430","11870","1590","840","1968","605000"
"3","1.5","1680","13751","1680","0","1951","572000"
"3","1.5","1980","10203","1680","300","1946","570000"
"3","2.5","2030","217805","2030","0","1999","565000"
"5","1","1690","3240","1690","0","1914","544500"
"3","2.5","2830","9972","2830","0","2006","539000"
"4","3","2240","5580","1830","410","1949","530000"
"4","2.5","2280","14810","1500","780","1977","515000"
"2","1","930","3750","930","0","1909","500000"
"3","1","1020","6120","1020","0","1941","485000"
"3","1","960","3600","960","0","1906","477000"
"3","1.5","2480","5280","1620","860","1947","475000"
"3","1","1140","4600","1140","0","1942","460000"
"3","1.75","1550","7270","1550","0","1953","453500"
"3","1","1270","8800","1270","0","1968","447000"
"3","2.25","1800","7371","1280","520","1979","425000"
"3","1.75","1770","6000","1130","640","1952","420000"
"4","2.5","2890","6322","2890","0","2011","416000"
"3","2.5","1553","1991","1553","0","2014","412000"
"3","2.5","1830","3200","1830","0","1999","410000"
"4","3","2430","7163","2430","0","2003","409950"
"3","2.25","1790","7125","1220","570","1974","392000"
"2","1","840","5400","840","0","1948","389100"
"3","2.25","1630","1598","1630","0","2008","385000"
"3","1","1540","7740","1540","0","1909","384950"
"3","2.25","1600","39848","1600","0","1958","380000"
"3","2.5","1330","1064","1330","0","2004","375000"
"3","3.25","1410","1442","1360","50","2006","358000"
"4","1","1430","8400","730","700","1969","351000"
"4","3","3380","16133","2330","1050","1959","350000"
"4","2.25","2700","8580","2700","0","1992","338150"
"5","3","1980","3868","1220","760","1990","333800"
"2","1","800","4533","600","200","1929","330000"
"5","1","1740","27350","1740","0","1958","320000"
"3","1.75","1600","14250","1070","530","1979","316500"
"3","2.5","1320","2614","1320","0","2005","300000"
"3","2","1310","169448","1310","0","1962","300000"
"4","2.5","1780","3600","1780","0","2006","296000"
"3","2.5","1860","5025","1860","0","2010","294900"
"4","1.75","1440","6720","720","720","1954","285000"
"4","2.75","2170","9658","2170","0","1966","275436"
"3","1.75","1710","7210","1240","470","1974","273148"
"3","1.5","1610","8375","1610","0","1927","270000"
"3","2.5","1480","9743","1480","0","1996","269950"
"2","1","770","8612","770","0","1953","269000"
"2","1","750","8125","750","0","1943","261000"
"3","3","1990","9600","1440","550","1988","245000"
"4","1","1610","24000","1610","0","1947","235000"
"3","1","1120","7500","1120","0","1965","230000"
"3","2.5","1520","2550","1520","0","2005","207000"
"4","1","1220","7980","1220","0","1944","165000"
"3","1","840","8400","840","0","1959","105000"
"4","2.25","4370","22863","3670","700","1907","2350000"
"4","3.25","5370","20388","5370","0","1990","1350000"
"4","3.25","4330","26162","4330","0","1997","1210000"
"4","2.5","3370","10602","3370","0","1999","1140000"
"4","2.5","3030","6820","2530","500","1947","998000"
"5","2.75","3170","7062","3170","0","2014","919950"
"3","2.5","2230","7200","2230","0","1996","836500"
"4","2.5","3320","52707","3320","0","1999","813000"
"4","3","2530","4560","1540","990","1925","785950"
"3","1.75","1990","5600","1330","660","1941","779000"
"3","2.25","2180","4200","1520","660","1939","727000"
"4","2.5","2970","29163","2970","0","1993","715000"
"4","2.75","2710","41811","1690","1020","1995","710000"
"4","3","3150","9318","3150","0","2001","705000"
"3","1.75","2600","7668","1300","1300","1968","700000"
"5","3.25","3940","9780","3940","0","2007","695000"
"3","1.75","1600","4400","1030","570","1941","690000"
"4","3.5","3770","47480","3770","0","2003","665000"
"3","2.5","2330","15536","2330","0","1996","665000"
"3","1.75","1458","858","950","508","2014","620000"
"3","2.5","1980","3128","1890","90","2009","615000"
"3","2.5","2010","3667","2010","0","2008","605000"
"3","2.25","2100","5562","2100","0","1979","600000"
"2","1.75","2470","5562","1140","1330","1916","597000"
"4","2.5","1690","4080","1140","550","1912","591500"
"3","2.5","2940","4799","1710","1230","1996","589000"
"3","2.5","2250","4337","2250","0","2004","589000"
"4","2.5","3110","6479","3110","0","2005","585000"
"3","1.75","1740","5500","970","770","1953","577000"
"2","1","1220","5040","1220","0","1961","555950"
"2","1","1510","11165","1510","0","1921","549000"
"3","2.5","1280","1845","1280","0","2009","545000"
"3","2.5","2520","5000","2520","0","1990","540000"
"2","1.25","1230","1569","1050","180","2009","540000"
"3","2","2350","209088","2350","0","1993","539000"
"2","2","1510","5133","1510","0","1939","535000"
"2","2.5","1900","2983","1900","0","2006","530000"
"2","2.25","1430","1210","1340","90","2005","522500"
"4","2.5","2160","9750","2160","0","1983","518000"
"3","2.25","2260","54014","1450","810","1962","514000"
"3","1.5","1360","11250","1360","0","1955","499950"
"3","3","2060","1850","1400","660","2007","497000"
"2","1.5","1920","6250","1060","860","1937","495000"
"2","2.25","1290","1137","1290","0","2007","481000"
"3","2.5","2270","4488","2270","0","1999","480000"
"4","1.5","1380","7800","1080","300","1928","477000"
"4","1","1420","6000","1420","0","1950","475000"
"3","1.5","1480","13457","1480","0","1959","475000"
"3","2.25","1420","990","1420","0","2008","467000"
"3","2.25","2080","50965","1590","490","1979","460000"
"3","2.5","1690","3827","1690","0","2005","449000"
"3","2.5","2360","4670","2360","0","1998","441500"
"4","1.5","1510","6460","1070","440","1970","435000"
"3","1","1550","4160","1550","0","1926","425000"
"2","1","930","5368","930","0","1953","420000"
"2","1","880","3200","880","0","1910","415000"
"3","2.5","3040","6054","3040","0","2005","410000"
"2","1","810","7440","810","0","1948","408000"
"5","2","2740","8230","2210","530","1962","407500"
"3","2.25","1430","1448","1430","0","2005","407000"
"3","2.25","1180","14258","1180","0","1987","400000"
"3","1","1000","6947","1000","0","1947","390000"
"3","2.25","1450","4667","1450","0","2009","382000"
"3","3.25","1450","1468","1100","350","2009","380000"
"2","1","1010","4050","1010","0","1950","375000"
"4","2.5","2340","13445","2340","0","1990","360000"
"3","2.5","1870","3584","1870","0","2003","345000"
"3","2.5","1620","5992","1620","0","2001","345000"
"4","2.25","2530","24700","2530","0","1974","340000"
"2","1","720","7250","720","0","1943","330000"
"3","2.25","2020","8379","2020","0","1994","328000"
"4","2.25","1800","4500","1800","0","2004","321000"
"3","2.25","1410","8909","1410","0","1988","318000"
"6","3.5","2120","5840","2120","0","1979","317000"
"1","1","570","6000","570","0","1918","310000"
"3","2.25","2110","7350","1530","580","1980","298700"
"3","1.75","1360","10742","960","400","1971","296000"
"3","1.75","1590","41550","1290","300","1933","295500"
"4","3","1730","7264","1730","0","1920","265000"
"4","2","2300","8400","1150","1150","1962","258750"
"3","2.5","1730","6930","1730","0","1994","258000"
"3","1","1450","7850","1450","0","1910","257000"
"3","1","1100","5000","1100","0","1960","249900"
"3","2.5","1490","2138","1490","0","2005","237000"
"3","1","1790","6120","1790","0","1937","225000"
"5","4.75","6200","13873","4440","1760","1989","3300000"
"4","3.75","4490","34982","4490","0","1998","1680000"
"6","3.25","3750","14150","2750","1000","1936","1250000"
"2","3","2330","3600","1870","460","1927","1050000"
"4","4.25","3250","19168","2360","890","1944","980000"
"6","2.25","3830","11180","2440","1390","1962","887000"
"6","2.5","3760","12978","2360","1400","1967","838300"
"3","2","1750","2640","1010","740","1914","808250"
"4","2.25","2130","8734","2130","0","1961","802000"
"3","2.5","2900","23550","1490","1410","1987","770000"
"4","2.5","3300","10764","1720","1580","1971","765000"
"4","1.75","2100","7960","1340","760","1955","735000"
"4","2.5","2860","6600","2860","0","2000","666500"
"3","2.5","3000","5000","2110","890","1918","666000"
"3","2","1940","6440","970","970","1940","651000"
"4","1.75","1550","7350","1550","0","1958","645000"
"3","2.75","2240","3600","1650","590","1901","625000"
"4","3","1540","4140","1540","0","1902","624000"
"5","3.5","3560","5008","2810","750","2013","616950"
"4","1.75","1770","9848","1370","400","1967","606150"
"5","1.75","2980","53578","2230","750","1976","575000"
"4","2.5","3010","6181","3010","0","2000","568500"
"5","3.5","2700","11675","1950","750","1948","565000"
"3","1.75","1480","383328","1480","0","1980","560000"
"3","2.5","2160","7584","2160","0","1988","555000"
"4","3","2670","5000","2670","0","1916","550000"
"4","3.5","3510","6005","2750","760","2010","540000"
"4","2.5","2710","9248","2710","0","2011","540000"
"3","1","1330","40259","1330","0","1977","535000"
"3","1.75","1680","7770","1680","0","1967","530000"
"3","2","3080","17700","1740","1340","1965","530000"
"5","1.75","2140","8580","1200","940","1962","528000"
"4","2.25","2330","19436","2330","0","1987","527000"
"4","2.5","2030","39049","1530","500","1953","515000"
"3","1","1180","6000","1180","0","1950","507000"
"3","1.5","1830","217800","1010","820","1981","505000"
"3","2.5","1820","1545","1640","180","1998","504500"
"3","2.5","1610","1728","1610","0","2000","499000"
"3","2.25","1820","8446","1820","0","1978","469000"
"5","3.5","3931","9497","2650","1281","2014","450000"
"1","1","850","6567","850","0","1940","440000"
"4","2.5","1540","1994","1540","0","2014","439990"
"3","2.25","2230","4551","1450","780","1928","439000"
"4","2.5","1970","8545","1970","0","2004","438000"
"3","2","1520","5040","1520","0","1977","434900"
"3","1.75","1540","9450","1040","500","1919","433500"
"3","2","1300","2250","1300","0","1988","422500"
"3","2","1380","15426","1380","0","1968","406430"
"3","1","1180","7210","1180","0","1963","383001"
"3","1.75","1260","11224","1260","0","1947","375000"
"1","1","800","533610","800","0","1950","375000"
"3","1.75","1310","7811","1310","0","1976","373000"
"4","2.75","2610","9426","1360","1250","1965","368000"
"3","2.5","1484","1761","1484","0","2003","365000"
"3","2.75","1420","955","1160","260","2004","362000"
"3","2.25","1445","1087","1300","145","2005","355000"
"3","2.25","2470","10290","2230","240","1984","350000"
"3","1","1240","10800","1240","0","1959","350000"
"2","1.75","1030","1066","765","265","2006","335000"
"4","1","1400","9384","1400","0","1948","325000"
"1","1","730","1942","730","0","2009","325000"
"3","1","1160","9750","1160","0","1968","322500"
"4","2.5","2440","7093","2440","0","1999","310000"
"3","2","1760","6092","1760","0","1998","295000"
"3","1","1440","4268","1040","400","1953","285000"
"5","2.25","2350","13000","2350","0","1961","277554"
"3","1.5","1950","7620","1010","940","1956","275000"
"3","2.25","1650","10000","1650","0","1988","266750"
"4","2.25","2300","7524","2300","0","1978","263850"
"3","2","1310","8069","1310","0","1990","240000"
"5","1","1920","19040","1160","760","1961","230000"
"3","2","1310","7332","1310","0","1987","230000"
"3","2","1760","9900","1760","0","1943","229000"
"4","1.5","1370","7944","1370","0","1961","219000"
"3","1","1220","22443","1220","0","1972","201000"
"1","1","720","5000","720","0","1908","185000"
"1","1","480","4560","480","0","1922","170000"
"3","1","1450","6776","1450","0","1952","150000"
"2","1","790","6426","790","0","1944","100000"
"5","3.75","4220","9240","3420","800","1991","1580000"
"3","3.25","3990","8505","2870","1120","1922","1500000"
"3","2.75","2730","38869","1940","790","1963","1340000"
"4","2.75","3410","7750","1710","1700","1958","1100000"
"4","3.25","3780","11200","3780","0","2002","1030000"
"4","3.25","3770","982998","3770","0","1992","998000"
"3","3.75","3710","34412","2910","800","1978","998000"
"4","2.5","3420","183387","3420","0","2000","975000"
"6","1","2330","5000","2330","0","1920","950000"
"5","2.5","4150","96574","4150","0","1988","930800"
"4","1.75","2800","5400","1400","1400","1924","863000"
"4","2.5","3480","6315","2360","1120","2000","852500"
"4","2.75","3130","13412","2140","990","1993","835000"
"3","3.25","3230","7639","3230","0","1999","817500"
"4","4","2680","6000","1380","1300","1962","777000"
"5","2.25","3060","13630","3060","0","1989","749999"
"4","2","2050","4400","2050","0","1922","740000"
"3","2.5","2410","9916","2410","0","1989","700000"
"3","3.75","2380","3600","1690","690","1927","695000"
"3","3.25","3080","12100","2080","1000","1984","695000"
"4","3","2160","4400","1320","840","1921","665000"
"3","1.5","1540","5040","1540","0","1907","659000"
"4","2.5","2370","9517","1630","740","1984","655000"
"4","2.5","2160","3139","1080","1080","1940","650000"
"3","2","1810","17006","1810","0","1913","649000"
"3","2","1650","7104","1650","0","1945","643500"
"3","1.75","1580","20588","1580","0","1970","625000"
"6","3","3030","31920","1670","1360","1980","624500"
"3","1.75","1720","8117","1170","550","1978","583500"
"4","2.5","2800","8190","1700","1100","1971","569500"
"3","2.25","1700","8800","850","850","1969","565000"
"3","2.5","2400","5500","2400","0","1983","562000"
"3","3","1330","5040","1120","210","2005","552100"
"3","2.5","1280","1889","1280","0","2009","540000"
"3","1.5","1380","4290","1080","300","1955","525000"
"4","2","2420","10735","2420","0","1967","525000"
"5","2.75","2620","8861","1350","1270","1979","519000"
"4","1.75","1520","9600","1000","520","1955","508450"
"4","2.5","2840","18001","2840","0","1994","500000"
"3","2.25","2010","7447","2010","0","1985","500000"
"3","2.5","3110","9015","3110","0","1990","485000"
"6","4.5","2940","7500","2940","0","1966","482500"
"3","1","1860","6360","1470","390","1954","460000"
"3","1.75","1420","8250","1420","0","1960","460000"
"4","1","1700","7689","1080","620","1977","456000"
"5","2.25","3470","28212","2790","680","1978","455000"
"3","2.5","2530","43733","1530","1000","1991","454000"
"4","2.5","2425","9017","2425","0","2013","447500"
"3","2.25","2100","205603","2100","0","1983","437500"
"4","2.5","2650","6000","2650","0","2000","428400"
"3","2.25","1450","1486","1160","290","2006","419700"
"2","1","720","4323","720","0","1942","405000"
"4","2.5","1850","9136","1850","0","1997","405000"
"4","2.5","2120","13780","2120","0","1993","403950"
"6","3","3320","15600","1660","1660","1977","400000"
"3","2","1500","2506","870","630","2003","395000"
"3","2.5","1720","4515","1720","0","2005","389000"
"4","1.75","1830","11090","1060","770","1962","383000"
"2","2","1340","4447","1340","0","2004","381000"
"3","1.75","1330","9417","710","620","1936","375000"
"4","2.25","1450","7245","1450","0","1950","375000"
"4","1.75","1680","6834","1680","0","1948","375000"
"2","2.25","1100","1695","1100","0","2009","374000"
"4","2.5","2720","8666","2720","0","1992","370000"
"2","2.25","860","696","860","0","2009","345000"
"3","1","980","7228","980","0","1946","340000"
"3","1.75","1410","16105","1410","0","1982","307000"
"3","1","910","8658","910","0","1955","306000"
"3","2.5","1981","5700","1981","0","2010","303700"
"4","2.5","2200","5730","2200","0","2003","299900"
"3","1.75","1250","9486","1250","0","1971","295000"
"4","2.5","2240","6944","1310","930","1979","287500"
"2","1","910","4662","910","0","1942","280000"
"4","1.75","2000","8700","1010","990","1975","275000"
"3","2","1380","3500","1380","0","1971","275000"
"3","1","1200","4592","800","400","1950","260000"
"3","2.5","1440","2500","1440","0","2006","260000"
"3","2.25","1810","11800","1240","570","1977","251700"
"4","2.25","2190","9113","2190","0","1986","245000"
"3","1.5","1580","10517","1580","0","1957","233500"
"2","1","1240","12092","960","280","1922","232000"
"4","2.5","1700","6675","1700","0","1997","215000"
"3","1.5","1250","9484","1250","0","1969","210000"
"2","1","790","5985","790","0","1944","200000"
"2","1","770","9370","770","0","1947","180000"
"3","1","920","7314","920","0","1960","125000"
"2","1","1560","5000","1560","0","1942","724000"
"2","1.5","1110","1200","1110","0","2000","320000"
"2","1","940","9330","940","0","1941","255000"
"3","1.75","2090","12026","2090","0","1948","248500"
"2","1","630","6000","630","0","1943","190000"
"4","1","1790","8400","1260","530","1954","401500"
"3","2.5","1800","2792","1800","0","2011","379900"
"4","3","3330","6990","2330","1000","1928","1240000"
"5","3.5","4180","17841","3160","1020","1990","1020000"
"4","2.5","2230","3600","1630","600","1906","1000000"
"4","3","4040","19700","4040","0","1987","988000"
"4","2.5","3600","6055","3600","0","2014","923990"
"4","2.75","3140","9085","1570","1570","1961","920000"
"4","2.5","3300","10250","2390","910","1946","905000"
"4","2.5","2520","4950","2520","0","1906","865000"
"5","3.5","3630","4911","2790","840","2014","834950"
"3","2.25","2780","6000","1670","1110","1948","834500"
"5","2.75","2860","6000","2380","480","1902","750000"
"3","1.75","1490","16200","1490","0","1958","685650"
"3","2.5","2920","9096","2920","0","2013","675900"
"4","2.75","3060","35380","1810","1250","1982","657000"
"3","1.75","1530","5000","1020","510","1948","635000"
"4","2.5","2540","4727","2540","0","1999","630000"
"3","2","1860","42800","930","930","1983","615000"
"3","2.25","2530","45234","2530","0","1985","615000"
"2","1","1530","6450","1530","0","1920","590000"
"3","2.5","2600","4438","2600","0","2004","581000"
"2","1.5","1990","6000","1430","560","1944","580000"
"3","1.75","1890","11141","1890","0","1968","575000"
"3","1.75","2580","40392","1390","1190","1986","570000"
"4","2.5","2120","9163","1450","670","1961","550000"
"4","3","2360","6678","1760","600","1949","550000"
"3","2.75","2230","14400","1460","770","1977","550000"
"3","2.5","2170","3200","1280","890","1923","539000"
"4","2.5","1720","3515","1470","250","2000","536500"
"3","1.5","1260","3135","780","480","1944","499000"
"4","2.5","2550","6382","2550","0","2007","492000"
"3","2.5","2430","5867","2430","0","2011","485000"
"3","2.5","1690","2890","1690","0","2004","475000"
"4","2.5","2320","7800","2320","0","1986","470101"
"3","2.5","1470","3000","930","540","1985","435000"
"3","2.25","1630","10500","1100","530","1974","425000"
"3","2.5","2070","3986","2070","0","1999","423700"
"4","2.25","2520","8000","1680","840","1970","415000"
"4","1.75","1510","9176","1510","0","1957","402000"
"4","2.25","2120","53578","2120","0","1985","379500"
"3","1","1290","10125","1290","0","1956","362000"
"1","2.25","2060","10600","1560","500","1927","360000"
"4","1.75","1680","9244","1680","0","1991","359000"
"4","2.5","2470","5015","2470","0","2004","352000"
"3","1","1010","8551","1010","0","1953","350000"
"3","1","1120","9134","1120","0","1972","343000"
"4","2.25","2060","8400","1300","760","1960","340000"
"2","1","1360","69260","1360","0","1937","335000"
"3","2.25","1770","8755","1330","440","1981","327500"
"3","1.75","2100","14850","2100","0","1963","323000"
"4","2.25","3340","8000","3340","0","1973","311000"
"2","1","1100","27007","1100","0","1943","303000"
"3","1","1010","6300","1010","0","1957","300000"
"4","2","2050","8750","1300","750","1967","300000"
"3","2.5","1870","8541","1870","0","1989","299990"
"3","1.75","1160","7006","1160","0","1992","285000"
"3","2.5","1890","3629","1890","0","2005","285000"
"3","1.5","1280","974","1280","0","2003","281000"
"3","1.75","1440","9253","990","450","1981","274000"
"3","2.25","1750","8400","1350","400","1965","270000"
"1","1","720","5196","720","0","1911","270000"
"3","1.75","1250","5546","1250","0","1987","268000"
"2","1","960","5150","960","0","1951","267500"
"3","1.5","1030","4000","1030","0","1952","267000"
"3","2.5","1410","2500","1410","0","2006","265000"
"3","1.5","1750","7000","1750","0","1983","260000"
"2","1","770","9497","770","0","1950","257000"
"3","2","1140","11161","1140","0","1998","250000"
"3","1.75","1450","12125","1450","0","1981","243000"
"3","1","1040","7800","1040","0","1948","240000"
"3","1.75","1480","7830","1480","0","1980","237500"
"2","1","810","8494","810","0","1949","237500"
"3","1","1200","7200","1200","0","1977","210000"
"3","1","1010","8108","1010","0","1955","200000"
"3","1","840","8470","840","0","1961","169950"
"4","4.75","4790","25412","4790","0","1999","1680000"
"4","4.25","5020","5432","5020","0","1998","1500000"
"4","3.25","3030","5164","2700","330","1925","1350000"
"5","2.5","3200","7863","1600","1600","1959","1310000"
"4","1.75","3080","6500","1700","1380","1941","1140000"
"4","4","3770","8899","2940","830","2006","1100000"
"3","1.75","1810","24586","930","880","1983","990000"
"4","2.5","2720","11049","2720","0","1989","975000"
"4","3","2980","44431","2640","340","1981","950000"
"4","2.5","3110","11422","3110","0","1989","925000"
"5","2.25","2700","9000","2700","0","1987","898000"
"2","1.75","1700","3618","1260","440","1950","895000"
"3","3.5","3820","145054","2870","950","1999","830000"
"5","3.5","4790","12957","3110","1680","2005","818500"
"4","2.5","2750","10159","2750","0","1991","812500"
"4","3.25","2110","3000","2110","0","2001","796000"
"4","2","1590","5400","990","600","1900","783200"
"4","2.5","2930","7806","2930","0","2005","782500"
"4","2.5","2990","5280","2210","780","2003","760000"
"3","2.5","2190","10000","1540","650","1957","760000"
"5","2.75","3360","9200","3360","0","2014","738515"
"3","3","2630","4972","2630","0","2006","731781"
"3","2.5","2070","7200","2070","0","2001","718000"
"3","2.75","2640","11957","2260","380","1978","698000"
"4","2.5","3160","6961","3160","0","2005","697000"
"2","1.75","2330","4000","1220","1110","1953","689000"
"4","3.5","2650","3474","2230","420","2011","665000"
"3","2.5","2650","11250","2650","0","2005","660000"
"4","3.5","3420","33106","3420","0","2004","655000"
"4","2.5","2740","9959","2740","0","1989","648000"
"4","2.5","1840","220308","1840","0","2000","620000"
"4","3.5","3110","6829","3110","0","2014","600600"
"3","1.75","2910","37461","1530","1380","1967","570000"
"5","4.25","3380","7805","3380","0","2014","569950"
"5","3","2200","6380","1440","760","1987","559900"
"3","1.5","1730","5750","1250","480","1947","550000"
"4","3.25","3420","5012","2330","1090","2008","548000"
"4","2.5","2710","6937","2710","0","2009","544999"
"3","1.75","1790","9860","1410","380","1978","539000"
"6","1.75","2460","6000","1230","1230","1913","535000"
"4","2.5","2830","6163","2830","0","2000","527000"
"2","1.75","1340","1368","1060","280","2006","520000"
"4","2.5","2020","7200","1010","1010","1968","495000"
"3","2.5","1650","3711","1650","0","1996","472500"
"5","4","3210","7200","2410","800","2011","465000"
"3","2.5","2190","17108","2190","0","1991","463000"
"3","2","1600","7350","1600","0","1979","460000"
"3","2.5","2130","5205","2130","0","2013","456000"
"7","4","3150","7800","3150","0","2013","450000"
"3","1.75","1300","7800","1300","0","1968","445950"
"5","2","2190","8316","1390","800","1961","437000"
"3","2.5","1340","8867","1340","0","1984","432500"
"2","1","1080","3600","1080","0","1922","429000"
"3","1.75","2500","6840","1300","1200","1957","425000"
"3","1.5","1970","13709","1680","290","1955","425000"
"3","1.75","1140","8558","1140","0","1982","420000"
"3","1.75","1760","5355","1160","600","1956","405000"
"5","2","2760","6420","1380","1380","1964","399950"
"3","1.75","1300","8480","1300","0","1969","397500"
"4","1","1440","8320","1440","0","1946","395000"
"3","2.25","2140","10256","2140","0","1987","393000"
"6","4","2700","7416","1350","1350","1969","385000"
"2","2.5","2110","114127","1590","520","1975","380000"
"4","2.75","3140","24800","2080","1060","1971","375000"
"3","2.5","2540","11562","1290","1250","1964","374950"
"4","2.5","3135","5811","3135","0","2005","374500"
"3","1.75","1570","6975","1040","530","1979","359950"
"3","2.75","2370","4632","2370","0","2002","350000"
"3","1","940","9198","940","0","1968","347000"
"3","1.75","1870","7500","1320","550","1978","344950"
"4","2","1590","9100","1040","550","1967","330000"
"3","2.5","1870","9825","1250","620","1994","325000"
"3","1","1990","7173","1990","0","1972","310000"
"3","1.5","1030","8414","1030","0","1967","301000"
"3","1.75","1830","51836","1430","400","1966","300000"
"2","1.75","1050","6500","1050","0","1925","295000"
"3","2","1700","6498","1700","0","1986","290000"
"3","1.5","1970","22486","1970","0","1968","289000"
"2","1","1260","4800","1100","160","1947","280000"
"3","1","1530","15975","970","560","1952","279000"
"5","1.5","2550","6300","1560","990","1959","272000"
"3","1","1240","14110","1240","0","1972","270000"
"3","2","1430","10850","1430","0","1994","234950"
"3","1","1010","8906","1010","0","1968","234000"
"2","1","920","7716","920","0","1944","229950"
"2","1","860","5800","860","0","1942","222900"
"3","1.5","1310","9273","1310","0","1968","222000"
"5","1","1260","8382","1260","0","1918","220000"
"3","1","1020","9147","1020","0","1900","214000"
"3","1","1010","8800","1010","0","1968","205000"
"4","2","1750","8116","1750","0","1943","199500"
"4","1","1470","18581","1470","0","1924","180000"
"3","2.5","1520","7200","1520","0","1985","158000"
"2","1","1040","20524","1040","0","1949","154000"
"5","3.5","3210","4060","2290","920","1917","1290000"
"5","4.5","3732","4426","2932","800","2001","1230000"
"5","3.25","5180","19606","2610","2570","1993","1200000"
"3","2.75","2980","12600","1590","1390","1941","900000"
"4","1","1670","4600","1670","0","1906","875000"
"4","2","3090","41147","3090","0","1990","870000"
"4","2.5","3340","9800","3340","0","2014","810000"
"4","2.5","2650","18903","2650","0","1994","745000"
"2","1.75","1728","95950","1728","0","2012","730000"
"3","3.25","3410","25741","3410","0","1993","720000"
"3","1.75","2040","4125","1540","500","1917","710500"
"4","2","2660","8160","1380","1280","1949","635000"
"3","2.25","1780","1429","1570","210","2007","620000"
"5","3.25","3920","4832","3030","890","2014","616200"
"3","2.75","2050","3320","1580","470","1927","613200"
"4","2.5","2660","35010","2660","0","1993","590000"
"4","2","2400","12753","2400","0","1962","585000"
"4","2.5","2370","15200","1660","710","1975","585000"
"4","2.25","2570","36465","2570","0","1980","580000"
"2","2.5","1280","1051","1080","200","2009","579000"
"3","3","1730","1902","1730","0","2014","566950"
"3","3","1720","70567","1720","0","1966","550388"
"2","1","1260","4000","1000","260","1940","549950"
"3","2.5","2080","8690","1430","650","1974","549950"
"4","2.5","2200","110642","1330","870","1979","535000"
"4","2.25","2970","54450","2970","0","1983","526000"
"3","1.75","2870","26500","2870","0","1948","525000"
"2","1","1510","3360","880","630","1924","525000"
"4","1.75","1730","7980","1730","0","1965","515000"
"3","1.75","1610","11950","1210","400","1984","510000"
"4","2.5","1890","7200","1500","390","1978","506500"
"3","3","2360","2750","1780","580","1983","498000"
"3","1.75","1510","11120","1510","0","1984","490000"
"5","2","1910","5508","1020","890","1968","485000"
"3","2.5","2540","51836","1820","720","1976","485000"
"2","1.75","1510","4555","1510","0","2005","473000"
"5","3.75","3860","6901","3860","0","2003","470000"
"4","1","1540","4500","1540","0","1905","462500"
"3","1","1290","47044","1150","140","1968","450000"
"4","2.5","2360","81892","2360","0","2000","445000"
"3","2.5","2420","9592","1780","640","1993","441500"
"3","1.75","1550","7820","1210","340","1981","440000"
"2","1","1000","6500","1000","0","1918","431000"
"4","2.5","2440","5088","2440","0","2007","425000"
"3","2.5","3310","21096","3310","0","2004","419000"
"7","3.25","4340","8521","2550","1790","1986","419000"
"1","1","1230","3774","830","400","1924","415000"
"4","1","1620","4329","1620","0","1927","415000"
"5","3.5","3672","9742","3006","666","2006","405000"
"5","3.5","2738","6031","2738","0","2014","395950"
"2","1.75","1150","2723","770","380","1923","390000"
"4","1","1710","117176","1710","0","1942","389900"
"4","2.5","2430","5556","2430","0","2003","381500"
"3","1.5","1540","8400","1540","0","1968","380000"
"3","1.5","1630","16170","1630","0","1988","375000"
"4","2.5","1900","9428","1900","0","1978","375000"
"4","2.5","2800","5000","2800","0","2006","375000"
"2","1","1140","5650","980","160","1920","374000"
"3","2.5","2080","4307","2080","0","2004","368000"
"3","1","1180","7573","1180","0","1977","355000"
"2","1","860","8511","860","0","1949","353000"
"4","2.5","2210","13721","2210","0","2009","353000"
"3","2.5","2540","4760","2540","0","2010","347500"
"5","2.75","2440","6858","2440","0","2003","340000"
"4","2.5","2310","6200","2310","0","1998","334000"
"3","2.25","1340","4080","1170","170","1907","330000"
"3","2.25","2140","7200","2140","0","1979","280000"
"2","1","1140","10404","1140","0","1935","275000"
"3","1","1190","27215","1190","0","1943","275000"
"4","1.5","1800","8786","1330","470","1966","272750"
"5","2.75","2920","5250","1800","1120","1911","265000"
"3","1","1420","7420","1420","0","1944","264250"
"3","1.5","1320","9750","1320","0","1954","260000"
"3","1","1690","13184","1690","0","1959","260000"
"2","1","840","7870","840","0","1949","251000"
"3","3","1790","2003","1480","310","2006","249950"
"2","1","1050","5900","1050","0","1950","245000"
"3","1","1020","5870","1020","0","1941","242500"
"3","1","940","7380","940","0","1959","242500"
"5","1","1500","9282","1500","0","1966","235000"
"3","1","1020","11652","1020","0","1971","216500"
"3","1","1190","7500","1190","0","1968","215000"
"3","1","1170","6134","1170","0","1948","209977"
"3","2","1410","8384","1410","0","1985","205000"
"3","1.75","1050","9871","1050","0","1968","199000"
"3","1","900","2550","900","0","1978","133400"
"3","4.25","5510","35000","4910","600","1997","3800000"
"4","3.25","4830","22257","4830","0","1990","3640000"
"2","2.75","3690","32044","3690","0","1989","1900000"
"6","2.75","4460","6952","3460","1000","1930","1870000"
"4","3.25","2910","1880","1830","1080","1914","1850000"
"5","3.5","3620","7821","2790","830","1958","1490000"
"4","2.5","3380","27589","3380","0","1966","1430000"
"3","3","2490","3600","1790","700","1911","1390000"
"4","3.25","3640","3604","1960","1680","1913","1270000"
"3","3.75","5400","24740","5400","0","1997","1210000"
"3","2.5","3160","24437","2160","1000","1991","1150000"
"4","3.5","2990","4200","2000","990","1925","1000000"
"4","1.75","2490","7834","1240","1250","1958","949000"
"4","3.5","3380","8098","1690","1690","1952","860000"
"5","2.75","4450","9600","3650","800","2014","845950"
"4","3.5","2840","40139","2840","0","1986","840000"
"2","2","1830","3600","1230","600","1926","825000"
"4","2.25","2190","4104","1410","780","1928","808000"
"4","2.5","3320","38032","3320","0","1991","805000"
"4","2.5","2540","28563","2540","0","1984","775000"
"3","2.5","2620","241200","2620","0","1998","775000"
"3","2.5","2310","7348","2310","0","2010","739000"
"4","3.5","3200","7605","2500","700","2013","735000"
"3","2.25","2040","130680","2040","0","1977","730000"
"4","2.5","2095","4400","1295","800","1910","711000"
"3","2.5","2880","36820","2880","0","1992","710800"
"2","1","1210","6000","1000","210","1942","710000"
"4","2.5","2550","7312","2550","0","1988","699000"
"3","2","2010","4320","2010","0","1999","699000"
"2","2","1450","989","1450","0","2014","680000"
"5","3","2970","6500","2970","0","2000","680000"
"3","1.75","1800","8000","1800","0","1972","665000"
"6","2.25","2450","25600","1340","1110","1957","662500"
"4","2.25","1910","5120","1300","610","1954","650000"
"3","2.5","2150","15304","2150","0","1979","649950"
"3","2.5","2290","14374","2290","0","1983","622500"
"3","2.25","2520","212137","1590","930","2005","620000"
"3","2.5","2340","3630","2340","0","1998","618000"
"5","3.5","3150","10542","1620","1530","1974","600000"
"4","2.5","2290","6318","2290","0","1988","599950"
"4","3","2710","217800","2710","0","2006","570000"
"3","2.5","2010","5200","2010","0","1989","559000"
"4","1.75","1760","94525","1760","0","1988","555000"
"3","3","3760","188760","2640","1120","1979","555000"
"2","1","1150","5000","1050","100","1924","552000"
"3","2.25","1360","5111","1360","0","1934","550000"
"4","3.5","2970","6587","2260","710","2014","549995"
"4","3.5","2660","5690","1920","740","2014","549995"
"3","2.25","2120","40518","2120","0","1967","530000"
"4","1.75","1540","8311","1540","0","1950","512500"
"2","2.5","1320","1157","990","330","2014","499950"
"4","2.25","2110","13457","2110","0","1974","475000"
"3","1.75","2180","7200","1090","1090","1954","472000"
"3","2.75","2300","5090","1700","600","2007","452000"
"5","3","2930","5500","1750","1180","1951","445000"
"4","2.5","2170","5257","2170","0","1989","445000"
"3","1.75","2100","29735","1080","1020","1957","440000"
"4","2.5","2990","7928","2990","0","2011","440000"
"2","1","1340","8100","1340","0","1953","438400"
"3","2.5","1960","4709","1960","0","2003","425000"
"4","2.5","2660","5539","2660","0","2004","423000"
"3","1","1440","5623","720","720","1922","420000"
"2","1","910","3750","910","0","1904","415000"
"4","2.25","2150","27345","2150","0","1976","410000"
"3","2.25","1190","1149","1050","140","2008","400000"
"5","2.75","2840","12253","1420","1420","1960","396000"
"2","1.75","1460","426450","960","500","1966","390500"
"2","1","860","1800","860","0","1909","390000"
"3","2.75","1810","3292","1810","0","2014","384205"
"4","1","1960","94525","1960","0","1979","371000"
"3","2","2460","53882","2460","0","1955","357000"
"5","2","1750","8220","1750","0","1956","340000"
"3","2.5","1260","1211","1260","0","2004","336000"
"2","1","1510","3844","1510","0","1923","335000"
"2","1","1070","6000","1070","0","1955","324000"
"3","1","1210","8505","1210","0","1958","315000"
"4","2.25","2130","9600","2130","0","1966","305000"
"3","2.5","1780","4650","1780","0","2011","299950"
"2","1","960","4000","960","0","1918","290000"
"4","2.25","1610","3560","1610","0","2010","288000"
"4","2.5","1820","7930","1820","0","1989","286000"
"2","1","1050","3088","1050","0","2005","285000"
"3","2.5","1610","6600","1610","0","1994","250000"
"3","2.5","2120","6840","1220","900","1984","248000"
"4","1","1120","8763","1120","0","1971","227000"
"2","1","720","4758","720","0","1947","225000"
"3","2.5","2040","15463","1340","700","1968","200126"
"4","1","1300","6030","1300","0","1947","175000"
"5","4.25","6510","16471","3250","3260","1980","1900000"
"5","4.25","4150","12015","4150","0","2014","1210000"
"5","3.25","4770","50094","3070","1700","1973","1040000"
"4","3.25","2830","8400","1910","920","1912","1030000"
"4","3.5","3780","20023","3780","0","2001","970000"
"4","2.75","2640","4000","1730","910","1925","895000"
"3","2.5","2820","14890","1770","1050","1985","853505"
"3","2.5","3300","11570","3300","0","1994","850000"
"3","2.5","2140","9897","2140","0","1959","799000"
"3","2.5","3680","203860","3680","0","1994","755000"
"3","1.75","2040","4000","1360","680","1924","720000"
"4","3.5","1930","5400","1930","0","1920","690000"
"3","2.5","2620","14248","1830","790","1977","680000"
"4","2.75","2280","3200","1520","760","1931","675000"
"4","3.5","2650","3127","2230","420","2011","674950"
"3","3.25","1510","2000","1330","180","2001","650000"
"3","2.5","2690","11575","2130","560","1957","650000"
"4","2.5","2330","45860","2330","0","1989","585000"
"4","2.5","2650","6875","2650","0","2014","569995"
"5","2.75","3370","10315","3370","0","2006","561000"
"3","2.5","2780","32880","2780","0","1993","560000"
"4","1.75","2030","5688","1730","300","1939","550000"
"3","3","2640","5978","2640","0","2012","535000"
"3","1","1150","7080","1150","0","1952","522000"
"4","2.25","2200","6900","2200","0","1975","512500"
"3","1.75","1920","43560","1340","580","1962","510000"
"3","2.5","2300","27566","2300","0","1995","510000"
"3","3","2130","5000","1570","560","1913","509000"
"3","2","1550","6394","1550","0","1918","500000"
"3","1.75","1340","6250","1090","250","1941","499950"
"3","3.5","3090","27598","2020","1070","1995","496000"
"3","2.25","1630","7573","1230","400","1983","490000"
"3","2.5","2400","7478","2400","0","2002","489950"
"2","2","2090","6000","2090","0","1918","477500"
"3","2.5","2280","6134","2280","0","2004","470000"
"3","1.75","1400","2003","700","700","1908","460000"
"4","2.5","3236","9608","3236","0","2005","450000"
"2","2.5","1460","1296","1160","300","2008","449000"
"4","2.5","2400","8038","2400","0","2002","440000"
"4","2.5","1700","6380","850","850","1940","435000"
"3","2.5","1730","4065","1730","0","1996","435000"
"2","1.5","901","1245","901","0","2001","435000"
"3","2.5","1710","5368","1510","200","2004","416000"
"3","1.75","1970","7100","1590","380","1976","408000"
"2","1.5","1070","937","1070","0","2003","350000"
"3","2.5","2240","7565","2240","0","1999","349950"
"2","2","1300","4659","1300","0","2005","344000"
"4","2.5","2360","7475","2360","0","1992","340000"
"3","2.5","1400","4800","1200","200","1921","340000"
"3","1.5","1210","7560","1210","0","1941","324950"
"3","2.5","1660","8125","1150","510","1999","295000"
"3","2.25","1610","10454","1610","0","1977","280000"
"2","2","800","5765","800","0","1936","278750"
"3","1.5","1400","6527","1110","290","1957","265000"
"2","1","670","4640","670","0","1943","250000"
"4","2.5","2040","5770","2040","0","1994","250000"
"2","2","1090","1357","1090","0","1990","249000"
"3","1","1020","6173","780","240","1948","235000"
"4","1.5","1160","6400","1160","0","1975","199000"
"3","1","880","19600","880","0","1978","196000"
"4","1.75","3100","21303","3100","0","1962","950000"
"3","2","1270","3090","1270","0","1911","570000"
"4","1","1360","5500","1360","0","1950","439500"
"3","1.5","1690","161913","1430","260","1952","370000"
"2","1.75","1560","43748","1560","0","1967","295000"
"4","2.5","2620","10489","2620","0","1990","683000"
"4","2.5","2230","12753","1180","1050","1981","600000"
"2","2","1680","4647","1680","0","2008","560000"
"4","1.75","1900","7313","1900","0","1973","340000"
"4","3.5","5440","9050","5440","0","1990","1770000"
"3","2.5","3060","9576","3060","0","2005","1270000"
"4","3.5","3590","5335","3140","450","2006","1210000"
"4","2.25","3740","18000","1870","1870","1951","1150000"
"4","3.75","4120","8258","4120","0","2012","949950"
"4","3","2720","11740","2720","0","1957","940000"
"3","3.25","2950","4446","2450","500","2001","930000"
"5","2.5","2490","9639","1610","880","1959","868500"
"4","3","3990","7838","3990","0","2003","810000"
"3","1","1980","3243","1980","0","1912","796000"
"3","2.5","1580","1487","1580","0","2009","779000"
"2","1.75","2230","6930","1530","700","1947","766500"
"4","1","2520","5500","1820","700","1912","765000"
"3","3.25","2250","60548","2250","0","2005","729000"
"5","3","3290","14134","1870","1420","2004","695000"
"3","1.75","2450","9377","1540","910","1962","687500"
"3","1.75","1300","2446","880","420","1961","676500"
"4","2.25","2260","8715","1530","730","1976","675000"
"3","2.5","2630","10047","2630","0","1996","665000"
"4","2.5","2080","8000","1220","860","1952","665000"
"3","1.75","2940","6000","1590","1350","1957","635000"
"3","2.5","2320","32772","2320","0","1992","630000"
"3","2.5","2510","47044","1910","600","1975","624000"
"3","1.75","1920","4000","1070","850","1950","615000"
"5","3.5","2950","7980","2350","600","2005","615000"
"4","2.25","2130","9000","2130","0","1965","586000"
"4","2.25","2060","12155","2060","0","1968","575000"
"3","3.5","1460","1021","1150","310","2006","570000"
"2","1.75","2870","102366","1770","1100","1994","570000"
"4","1.5","1790","3420","1020","770","1923","560000"
"3","2.75","1960","13252","1240","720","1975","550000"
"3","2.25","2100","20018","1470","630","1948","540000"
"4","1.75","2230","7957","2230","0","1967","537000"
"3","2","1600","16530","1600","0","1967","525000"
"3","2.5","1740","2350","1120","620","1996","525000"
"3","1.75","2420","65501","2420","0","1984","500000"
"2","1.75","2040","114562","2040","0","1968","499000"
"3","2.75","1720","6720","1270","450","1947","493000"
"3","2.5","2270","7887","2270","0","2004","485000"
"4","2.5","3150","5757","3150","0","2004","475000"
"2","2.5","1240","1249","1240","0","2006","459000"
"2","1.75","990","5850","990","0","1942","458000"
"3","1","1210","9473","1210","0","1955","453000"
"3","2.5","2790","48994","2790","0","1984","450000"
"2","2","1510","4908","1510","0","2006","450000"
"3","1.5","1440","9711","1140","300","1956","450000"
"3","2.5","2230","5800","2230","0","2004","440000"
"4","3.5","3180","4869","2390","790","2007","440000"
"2","1.75","1910","12142","1910","0","1976","435000"
"3","1.75","1930","7210","1110","820","1975","434500"
"5","3","3880","8432","3880","0","2004","430000"
"2","1.5","1400","4160","1400","0","1947","421000"
"3","1","1060","12690","1060","0","1969","400000"
"3","1.75","2340","5668","1200","1140","1941","396000"
"4","3.75","2220","3797","1330","890","1917","392000"
"4","1","1280","4840","940","340","1950","390000"
"5","2.75","3220","8160","3220","0","1999","384000"
"3","2.5","2430","7857","1730","700","1980","359000"
"3","1","1360","8968","1360","0","1956","355000"
"2","1","1280","5250","1140","140","1942","350000"
"3","1.75","1270","4800","1270","0","1953","335000"
"3","1.75","1880","16262","1880","0","1980","334950"
"5","2.5","3597","4972","3597","0","2006","330000"
"3","1","980","6530","980","0","1969","307500"
"3","1.75","1980","9800","1980","0","1991","306000"
"4","2.5","1740","7895","1740","0","1999","302000"
"4","2.25","1740","9613","1740","0","1989","300000"
"2","1","800","3000","800","0","1904","299950"
"3","2.5","1690","169448","1690","0","2003","293000"
"4","2.25","1930","8925","1930","0","1974","289000"
"3","2","1300","5000","1300","0","1983","240000"
"4","1.75","1550","9899","1550","0","1967","229900"
"4","2","2220","14120","1200","1020","1966","225000"
"2","1","1210","18700","1210","0","1940","198900"
"3","2","1080","9225","1080","0","1955","147400"
"1","1","640","10280","640","0","1920","110000"
"2","1","830","9000","830","0","1939","85000"
"3","2.5","3280","29111","3280","0","1925","1880000"
"3","3.25","3780","10623","2650","1130","1999","1150000"
"4","2.5","3320","9380","3320","0","1988","1110000"
"4","3","2770","2650","2180","590","2014","1110000"
"4","1.75","2120","4000","1920","200","1929","980000"
"4","3","2370","3836","1750","620","1969","957000"
"4","3.5","2800","6750","1890","910","1951","880000"
"3","2","1570","4625","1570","0","1927","835000"
"3","1.5","1180","8545","1180","0","1952","816000"
"3","2.25","2170","5001","2170","0","2014","802000"
"5","2.5","3320","9024","3320","0","1999","800000"
"4","2.5","1710","9627","1440","270","1976","749000"
"3","2.5","3020","50800","1510","1510","1968","735000"
"4","1.75","2620","11041","2620","0","1962","720000"
"5","2","3110","6131","1560","1550","1940","719000"
"4","2.75","2240","8937","1460","780","1976","675000"
"4","2.75","2100","11894","1720","380","1968","640000"
"5","3.25","3710","34200","2510","1200","1986","635000"
"4","2.5","2980","9235","1690","1290","1977","623000"
"3","1.5","1780","4200","1780","0","1916","588000"
"3","3.5","1700","2197","1260","440","2010","585000"
"3","1.75","2120","10875","1540","580","1977","578000"
"4","1.75","1740","8800","1740","0","1965","560000"
"4","1.75","2350","5946","1350","1000","1957","555000"
"3","2.5","2080","7749","2080","0","1988","550000"
"2","1.5","1300","2970","990","310","1903","550000"
"2","0.75","1040","4000","930","110","1909","550000"
"4","2.5","3020","6788","3020","0","2002","530000"
"3","2.5","1970","9153","1970","0","2007","509950"
"4","1.5","1330","5750","1330","0","1915","500000"
"2","2","1510","3961","1510","0","2010","485000"
"3","2","1860","7232","1320","540","1985","460000"
"4","2.25","2550","10000","1560","990","1979","452250"
"3","1.75","1850","8667","880","970","1982","450000"
"3","1.75","1830","5488","1010","820","1939","450000"
"3","1.75","1850","16863","1280","570","1980","445000"
"3","2.25","1760","1800","1330","430","1983","440000"
"3","2.75","2600","12860","1350","1250","1965","430000"
"2","2","1350","4225","1350","0","2003","428000"
"3","2.5","2050","3218","2050","0","2008","427000"
"4","2.25","2120","7700","1490","630","1976","426000"
"2","1","970","2970","970","0","1910","425000"
"3","3.25","1410","1350","1410","0","2005","425000"
"4","1","1080","4160","1080","0","1924","425000"
"5","2.25","3070","64033","2730","340","1983","420000"
"3","2.25","2280","8500","1680","600","1977","419950"
"4","2","1350","7255","1350","0","1959","400000"
"4","2.5","2150","5397","2150","0","1998","400000"
"2","1","1010","4000","1010","0","1911","385000"
"4","1.75","1790","10186","1790","0","1965","380000"
"2","1","930","5400","930","0","1952","379000"
"2","1","680","4800","680","0","1917","365000"
"4","2.25","1930","6508","1930","0","1996","360000"
"5","2.5","2130","7111","1330","800","1968","360000"
"3","2.25","2280","8765","2280","0","1977","356000"
"3","2.75","2170","8396","2170","0","1995","353000"
"3","2.75","3070","5280","2360","710","1950","350000"
"4","2.5","2720","7697","2120","600","1987","348000"
"3","1.75","1320","9450","1320","0","1943","338995"
"3","1","1620","5040","1120","500","1964","333000"
"4","1.75","1880","9880","1880","0","1967","333000"
"3","1","1570","9136","1570","0","1953","330000"
"3","1.75","1670","5209","1670","0","1908","329900"
"4","2.5","2430","5366","2430","0","2002","321000"
"3","2.5","1980","9907","1980","0","1991","319950"
"3","2.5","1980","4500","1980","0","2012","317950"
"3","1","1390","8333","1390","0","1982","315000"
"4","2","1890","8362","1890","0","1966","312000"
"4","1","1030","5750","1030","0","1971","310000"
"2","1","780","4132","780","0","1942","289000"
"3","1.5","1380","12196","1380","0","1967","285000"
"6","3","2400","9373","2400","0","1991","280000"
"4","2.5","2040","8076","2040","0","1994","279000"
"3","1.75","1540","12600","1160","380","1980","272500"
"2","1.5","1380","209959","1380","0","1954","270000"
"3","2.5","1730","6653","1360","370","1990","269000"
"1","1","710","4725","710","0","1939","264000"
"4","2.75","2250","5000","1320","930","1984","260000"
"3","1","1500","6600","1500","0","1970","243000"
"3","1","970","9600","970","0","1972","242000"
"3","1.75","1380","8362","1380","0","1967","235000"
"4","2.5","1960","7875","1220","740","1978","234500"
"3","1","1190","9083","1190","0","1955","230000"
"3","1","1190","9199","1190","0","1955","228000"
"3","1.75","1610","14182","1100","510","1978","225000"
"2","2","1310","2550","1310","0","2004","219000"
"3","1.5","1150","11571","1150","0","1961","213500"
"3","1","1030","60720","1030","0","1912","209900"
"2","1","680","6400","680","0","1943","179900"
"3","1","1180","9832","1180","0","1970","169950"
"3","1","910","5800","910","0","1900","169900"
"2","1","810","4755","810","0","1980","155000"
"2","1","790","7153","790","0","1944","118125"
"4","3.25","4580","4838","3080","1500","1991","2900000"
"4","2.5","2980","13341","1800","1180","1928","1600000"
"4","2.5","2790","5450","1930","860","1925","1160000"
"6","3.25","3560","107362","2760","800","1963","1100000"
"3","2.75","2500","6350","2370","130","1979","990000"
"3","2.5","2830","3750","2830","0","2014","959000"
"4","3","2940","7108","2220","720","2011","870000"
"4","4","3650","18223","3330","320","2013","799900"
"5","2.5","3040","9570","1640","1400","1966","795000"
"4","3","2440","3600","1480","960","1929","780000"
"3","1.5","1590","7080","1310","280","1952","720000"
"4","2.5","2740","7571","2740","0","2009","706000"
"4","1.75","1690","11739","1690","0","1959","705000"
"5","2.25","3210","61419","3210","0","1979","696500"
"4","3.5","3420","49223","3420","0","2004","679000"
"4","2.5","2810","11560","1740","1070","1962","674000"
"3","3","3040","5067","3040","0","1993","653000"
"4","2.5","3050","7238","3050","0","1989","635000"
"2","2.5","2470","8840","1780","690","2001","635000"
"5","3.25","3500","7254","2760","740","2005","632500"
"4","2.5","2070","8127","1590","480","1924","600000"
"2","1","1150","3775","1150","0","1917","599950"
"3","2.5","2520","10223","2520","0","1988","590000"
"3","3.25","1290","1230","1090","200","2008","590000"
"4","2.75","3220","9825","3220","0","2012","579000"
"4","2.25","2310","9800","1780","530","1968","561500"
"3","2","2330","3600","1580","750","1900","549000"
"3","2","2850","19200","2340","510","2004","545400"
"3","1.75","1830","4500","1830","0","1909","518000"
"3","2.25","1640","4635","1540","100","1930","517000"
"3","1.5","2040","6750","1280","760","1950","500000"
"3","2.75","1980","3128","1980","0","1979","490000"
"4","2.5","3480","12696","1980","1500","1977","490000"
"5","1.5","2180","4268","1340","840","1924","470000"
"4","2.75","2680","16934","1340","1340","1958","445000"
"3","1.5","1690","6010","1230","460","1946","440000"
"3","1.75","1990","9885","1030","960","1978","438000"
"2","1.75","1800","224769","1420","380","1950","400000"
"3","2","1840","16815","960","880","1972","390000"
"3","2","1450","7300","1450","0","1955","375000"
"4","1.5","1770","6650","1770","0","1958","375000"
"2","2","1440","15000","1440","0","1985","365000"
"3","1.75","1240","7620","1240","0","1968","361810"
"3","1.75","2130","8742","1330","800","1955","361000"
"6","4.5","3500","8504","3500","0","1980","350000"
"3","1.75","1240","38095","1240","0","1978","345000"
"3","1","940","10500","940","0","1966","342500"
"2","0.75","1060","48292","560","500","1947","340000"
"3","1.75","1270","8422","1270","0","1967","340000"
"4","2.5","2717","4513","2717","0","2005","338500"
"3","1","1250","4548","1250","0","1954","333000"
"3","1","1850","5775","1740","110","1928","330000"
"3","1","1150","7486","1150","0","1970","325000"
"3","3","2240","11536","2240","0","1943","323500"
"3","2.5","1680","4584","1680","0","2003","320000"
"3","2.25","1540","17424","1540","0","1992","315000"
"3","1","1160","3700","1160","0","1909","315000"
"4","2.75","2370","7320","2370","0","1989","310000"
"3","1","1160","9750","1160","0","1967","305000"
"6","3","2744","9926","2744","0","2006","300000"
"4","1","1170","5400","1170","0","1953","299950"
"3","2.75","3080","19635","1610","1470","1958","299000"
"3","1","1550","8778","1250","300","1952","299000"
"3","2.25","2420","7548","1370","1050","1967","282000"
"1","1","640","6350","640","0","1939","279200"
"3","2.5","1650","5994","1650","0","1989","273000"
"3","2.5","1808","19200","1808","0","2005","270000"
"3","2.25","1740","10378","1740","0","1977","255000"
"2","1.5","1200","5773","1200","0","1985","250000"
"2","1.75","1290","1493","1290","0","2014","239800"
"4","2","1440","5911","1440","0","1943","232000"
"3","1","960","15273","960","0","1963","201000"
"2","2.75","1590","20917","1590","0","1920","199950"
"2","2.5","1660","2258","1660","0","1981","160000"
"5","4.75","6240","47480","4610","1630","2003","2950000"
"4","2.25","4250","16940","2380","1870","1974","1530000"
"3","2.5","4570","10615","4570","0","1991","1040000"
"5","3.25","4260","7861","4260","0","2005","994000"
"4","1.75","2440","11793","1420","1020","1950","925000"
"3","3.5","2940","6431","2940","0","2014","914154"
"2","2.5","2000","5150","2000","0","1992","910000"
"4","2.75","3540","5500","3540","0","2014","888990"
"3","2","2590","3750","1790","800","1904","885000"
"3","2.5","3260","91911","3260","0","1984","850000"
"4","2.5","2900","9972","2900","0","1993","850000"
"4","2.5","3490","18521","3490","0","1990","734000"
"5","3.5","3760","4857","2820","940","2004","730000"
"4","3.5","2600","5100","1820","780","2003","722500"
"5","3.5","4140","7642","4140","0","2003","720000"
"4","2.75","2940","4232","2940","0","2004","710000"
"4","1","1680","4087","1680","0","1911","709000"
"4","1.5","1910","5000","1610","300","1912","657500"
"3","1","1500","2400","1500","0","1900","614950"
"3","2.25","1960","10385","1960","0","1988","613000"
"3","2.5","2630","10131","2630","0","1989","609000"
"3","1.5","1860","7190","1860","0","1952","580000"
"3","2.75","1430","1521","1130","300","2009","580000"
"3","1.75","1720","4050","860","860","1906","575000"
"4","1.75","1900","10297","1900","0","1966","566000"
"3","2.5","2840","216493","2840","0","1991","560000"
"5","3","2730","9519","1670","1060","2014","559950"
"3","2.25","2160","15360","1410","750","1965","550000"
"3","2.5","1720","11656","1720","0","1987","540000"
"3","2.5","2860","8935","2860","0","2004","540000"
"3","1.75","2020","10031","1370","650","1952","535000"
"5","2.25","1950","8025","1150","800","1960","525126"
"2","1","880","4000","880","0","1940","525000"
"4","1.75","1650","8560","1650","0","1970","525000"
"2","1.5","960","7200","960","0","1910","525000"
"2","2.75","1310","1268","1310","0","2007","525000"
"4","2.25","2350","12540","2350","0","1968","505000"
"3","2.5","2090","8505","2090","0","1951","499000"
"3","2.25","1460","1353","1050","410","2012","497000"
"3","1.5","1790","229125","1790","0","1987","475000"
"3","2","1560","8509","790","770","1969","465000"
"3","2.5","1690","5131","1690","0","1941","460000"
"3","2.25","1620","997","1540","80","2010","425000"
"3","1","1320","5500","1320","0","1955","420000"
"3","1","1380","7015","1380","0","1925","408000"
"4","2.5","2640","4725","2640","0","2014","389517"
"3","2.5","1980","17342","1580","400","1984","380000"
"3","2.5","2420","4725","2420","0","2014","369946"
"3","2.5","2420","4725","2420","0","2014","367899"
"3","1.75","1680","6108","1680","0","1989","366000"
"2","1","1210","3090","860","350","1926","366000"
"4","2.5","2140","7350","2140","0","1985","365000"
"3","2","1960","8846","980","980","1940","360000"
"3","2.5","2517","3900","2517","0","2014","353900"
"5","3","2520","5500","1550","970","2004","350000"
"2","1","1130","8081","1130","0","1921","345000"
"3","2","1340","10200","1340","0","1953","339950"
"4","2.25","1790","9920","1170","620","1969","330000"
"3","2.25","2220","16020","1780","440","1966","325000"
"3","1","990","7050","990","0","1967","310000"
"2","1.5","1510","9843","1510","0","1961","309950"
"4","1.5","1580","10230","790","790","1945","299980"
"5","2.25","2300","11505","1300","1000","1963","298950"
"3","2.5","1410","1332","960","450","2014","295500"
"3","2.25","1860","13939","1860","0","1961","291000"
"4","1","1340","22500","1340","0","1926","275000"
"4","1.75","1960","6177","1960","0","1967","275000"
"4","1.75","1390","10660","1030","360","1960","272000"
"1","1","1020","7920","1020","0","1947","269000"
"4","2","2560","12155","1350","1210","1960","255000"
"3","1.75","1350","8548","1350","0","1985","250000"
"3","2","1590","8100","1060","530","1996","250000"
"3","1","1470","7680","1220","250","1946","248000"
"3","2.25","1650","3788","1650","0","1985","233703"
"3","1","1130","10018","1130","0","1954","227000"
"3","1","1110","9827","1110","0","1966","217000"
"4","1","1130","7400","1130","0","1969","215000"
"3","1.5","1610","5304","1610","0","1968","215000"
"2","1","800","10625","800","0","1942","109500"
"6","7.75","9890","31374","8860","1030","2001","6890000"
"3","2.25","2480","15022","1330","1150","1967","1050000"
"3","1.75","2520","4534","1460","1060","1954","849000"
"4","2.5","3720","35000","3720","0","1983","828500"
"4","1","1820","4000","1820","0","1923","825000"
"4","3.25","3520","5250","3520","0","2012","795000"
"4","2.75","2840","4864","2840","0","2014","779950"
"4","2.5","2780","6737","2780","0","2002","739000"
"4","3.5","3260","110579","3260","0","1997","715000"
"3","2","1820","4080","1820","0","1937","699000"
"3","1.5","1760","4880","1290","470","1928","688000"
"3","2.5","2440","4587","2440","0","2010","677900"
"3","1","1260","24550","1260","0","1937","665000"
"4","2.75","2640","6240","2640","0","2001","650000"
"4","3.5","4083","68377","4083","0","2005","637000"
"3","3.5","1560","1490","1240","320","1995","625000"
"2","1.75","1460","1500","1000","460","2008","625000"
"2","1.75","1680","8187","1680","0","1983","620000"
"4","2.25","1920","3225","1300","620","1923","595000"
"3","2","3030","9374","2100","930","1959","590000"
"3","1.75","2040","81021","2040","0","1980","580000"
"3","1","1800","4005","1160","640","1929","556000"
"4","2","1680","2600","840","840","1915","555000"
"2","2.75","1950","1610","1950","0","2009","555000"
"4","2.75","3080","6731","3080","0","2003","550000"
"4","2.5","2810","7549","2810","0","1992","550000"
"5","3","3610","7555","3610","0","2003","549900"
"3","1.75","2280","16671","1760","520","1909","540000"
"3","2.25","2070","7207","1720","350","1973","535100"
"2","1.5","1940","5700","970","970","1937","535000"
"2","2.25","1260","1312","1260","0","2007","530000"
"3","3.25","1220","1281","930","290","2014","526000"
"4","2.5","2450","5280","2450","0","2003","525000"
"3","1.75","1600","20873","1600","0","1955","515000"
"4","1.75","2570","12039","1910","660","1978","495000"
"4","2.25","2090","10869","2090","0","1970","490000"
"3","2","1510","3000","910","600","1972","489000"
"3","2.25","1620","8701","1220","400","1962","469950"
"5","3","3223","6371","3223","0","2014","469950"
"3","2.5","2180","4226","2180","0","2004","450000"
"3","2.5","1260","1125","1260","0","2002","437500"
"3","2.5","1460","1238","1200","260","2008","436000"
"2","1","720","5600","720","0","1920","435000"
"2","1","2240","7200","1120","1120","1940","435000"
"3","2.5","1660","15000","1660","0","1970","432000"
"4","2.5","2220","6800","2220","0","2002","419950"
"4","1.75","2060","7900","1070","990","1957","395000"
"4","2.5","2245","4330","2245","0","2014","389990"
"4","2.5","2640","5595","2640","0","2011","387990"
"4","1.75","2100","7135","1050","1050","1955","384000"
"3","2.5","1580","3075","1580","0","2013","379000"
"3","1","1130","12500","1130","0","1954","375000"
"4","1.5","1890","6052","1890","0","1955","359000"
"3","2.5","1400","1529","1400","0","2005","358000"
"3","1","920","3863","920","0","1970","356000"
"3","2.5","2440","18674","2440","0","1994","350000"
"3","1.75","2010","6150","2010","0","1939","350000"
"4","2.5","1530","2248","1530","0","1914","350000"
"4","3","2380","20277","1500","880","1999","340000"
"3","2.5","1700","6698","1700","0","1997","335000"
"4","2.5","2910","8596","2910","0","2004","312200"
"3","1.5","1200","15606","1200","0","1985","309950"
"4","2.5","1914","3150","1914","0","2009","305000"
"2","1","920","5850","920","0","1900","285000"
"5","3","2110","5260","1670","440","2002","285000"
"4","2.5","1934","5677","1934","0","2013","280000"
"3","2.5","1540","7280","1080","460","1974","279000"
"4","2.5","2500","9654","1830","670","1979","241500"
"3","1","1290","8470","970","320","1966","225000"
"5","1.5","1830","94960","1830","0","1929","220000"
"3","1","1150","7560","1150","0","1958","215000"
"3","2.5","1390","2450","1390","0","2009","208800"
"3","1","1510","4350","1510","0","1913","195000"
"3","1","1320","7155","1320","0","1961","185000"
"4","2","1440","7641","1440","0","1943","162000"
"2","1","1070","20450","1070","0","1948","95000"
"2","1.5","1210","5000","1210","0","1907","615000"
"4","2","1970","3515","1030","940","1969","535000"
"3","2.5","2410","4656","2410","0","2009","480000"
"5","1.75","1550","6986","1030","520","1978","318500"
"3","1.5","1050","5525","1050","0","1969","195000"
"5","2.25","3270","16553","2470","800","1968","1180000"
"2","2","1490","713","1490","0","2014","700000"
"5","2.5","2760","4000","1730","1030","1926","575000"
"4","3.25","2670","5001","1640","1030","2013","500000"
"2","1","870","7227","870","0","1948","312500"
"4","3.5","3280","3800","2880","400","2011","2580000"
"4","4.5","3860","15246","2940","920","2004","1700000"
"4","2.5","3450","17400","2180","1270","1964","1390000"
"2","2.25","2160","17861","2160","0","1956","1200000"
"4","2.75","4510","5000","3270","1240","1941","1060000"
"5","2.5","3050","8200","1650","1400","1962","1030000"
"3","3.25","3620","8131","2730","890","1988","996000"
"3","1","1630","6603","1630","0","1912","925000"
"4","2.5","3620","42580","3620","0","1984","900000"
"4","2.75","2610","4400","1260","1350","1920","890000"
"4","4","3610","12811","3610","0","2000","870000"
"4","2.5","2260","13600","1770","490","1974","865000"
"4","2.75","2270","14565","2270","0","1965","855000"
"3","3.5","3010","5717","3010","0","2000","848000"
"4","3.5","3030","5494","3030","0","2014","799950"
"2","3.25","3000","24004","2410","590","1952","780000"
"3","3.25","3310","5000","3310","0","2006","770000"
"3","2","2660","5000","1940","720","1910","727500"
"4","3","1986","6000","1746","240","1922","715000"
"5","2.75","2580","9242","1720","860","1967","713000"
"4","2.25","2380","16236","1540","840","1961","699900"
"2","2","1780","3810","980","800","1922","691000"
"3","2","2520","5980","1790","730","1957","650000"
"4","2.5","2500","8282","2500","0","2013","620000"
"4","2.25","2330","7020","1450","880","1973","615000"
"7","4","2690","10880","2690","0","1960","597157"
"3","2","1460","3600","1460","0","1902","591000"
"3","2.5","1880","12368","1260","620","1967","565000"
"4","2.5","2780","7838","2780","0","2004","563500"
"3","2.25","1640","7200","1640","0","1985","561000"
"3","2.25","1700","1481","1700","0","2002","550000"
"3","1.75","1400","4000","1400","0","1925","545000"
"1","1","920","5000","920","0","1906","535000"
"4","2.25","1890","8549","1890","0","1967","525000"
"4","2.5","2140","7754","2140","0","1996","525000"
"3","2","1600","4510","990","610","1978","510000"
"4","1.75","2290","9215","1270","1020","1969","500000"
"3","1.75","1530","14633","1100","430","1977","500000"
"3","2.5","1880","5502","1880","0","1988","485000"
"3","2.5","2130","8022","2130","0","1985","475000"
"3","2.5","2120","2374","1770","350","2005","470000"
"3","2.5","2000","8424","1300","700","1968","470000"
"4","2.5","2470","8536","2470","0","2002","470000"
"3","1.75","1640","4579","1640","0","1916","443000"
"3","1.5","2260","5300","1200","1060","1940","440000"
"3","1.75","1440","4025","720","720","1917","430000"
"3","2.25","1840","11403","1840","0","1993","417000"
"3","1.5","1240","12400","1240","0","1958","415500"
"4","2.25","1770","5236","1770","0","2007","413900"
"3","2.5","2070","4697","2070","0","2002","405000"
"3","1.75","1410","15210","1410","0","1950","404000"
"3","2.25","1350","2839","1350","0","2003","401000"
"4","1.5","1980","113691","1980","0","1962","400000"
"3","1.75","1560","8456","1560","0","1970","400000"
"4","1","1420","6458","1420","0","1953","398000"
"3","1.5","1180","7700","1180","0","1959","390000"
"3","2","2140","26600","2140","0","1983","365000"
"3","1","950","8450","950","0","1962","365000"
"4","2.25","1750","10270","1750","0","1968","364000"
"4","2.5","2680","7700","2680","0","1990","363500"
"3","1.5","1340","1110","1040","300","1999","360000"
"3","1.5","1360","6000","860","500","1911","360000"
"3","2.25","1900","3800","1900","0","2006","353000"
"3","3.25","1340","1151","1340","0","2008","349000"
"3","1","1350","8581","1350","0","1944","345500"
"3","2.5","1900","5194","1900","0","2004","343500"
"4","2.5","2240","9701","2240","0","1989","335000"
"3","2.5","1730","3600","1730","0","2014","329780"
"4","1","1530","12040","1130","400","1957","325000"
"3","2","1220","7620","720","500","1947","320600"
"4","2.5","2320","7379","2320","0","1987","316000"
"3","2.5","1950","9618","1950","0","1992","315000"
"3","1.5","1320","15053","1320","0","1979","300000"
"3","2.25","1670","6600","1670","0","1990","289000"
"4","2.25","2270","11997","1540","730","1959","287000"
"4","2.5","1710","3500","1710","0","2014","282900"
"2","1","700","5940","700","0","1948","282150"
"2","1","1060","6504","1060","0","1950","275053"
"4","1.75","1680","9966","1100","580","1977","268000"
"3","1","1400","9460","1060","340","1961","265000"
"3","1.75","1490","3800","700","790","1913","263000"
"3","1.75","2170","10018","1630","540","1978","260000"
"4","2.5","1580","7800","1580","0","1959","255000"
"3","2.5","1794","4769","1794","0","2005","254950"
"3","2.5","1560","10608","1560","0","1994","254000"
"3","1.75","1550","1905","1550","0","2005","242500"
"3","1.75","1510","9837","1510","0","1989","227000"
"4","2.5","2130","9100","1290","840","1978","220000"
"3","1.5","1460","11100","1460","0","1956","207000"
"3","1","1480","5670","780","700","1944","170000"
"3","1","1090","2800","1090","0","1969","149000"
"6","5","7100","18200","5240","1860","1933","3200000"
"4","3.75","4475","20424","2659","1816","1999","2570000"
"4","3.25","3980","10249","3980","0","2011","1770000"
"5","2.5","4570","19252","4570","0","1965","1480000"
"5","4","4390","6656","2930","1460","2008","1230000"
"5","2.5","2860","4000","2160","700","1910","1200000"
"6","4","3600","6224","2610","990","1945","1110000"
"5","3.5","3740","5610","2860","880","2014","1080000"
"3","2.75","2370","8900","1670","700","1971","1000000"
"3","2.5","2460","10300","2460","0","1992","995000"
"3","2.5","2290","9158","2290","0","1984","822000"
"3","1.75","2590","32380","2590","0","1951","808000"
"5","3.5","2770","9305","2770","0","1985","804000"
"4","2.5","3310","5101","3310","0","2005","775000"
"4","3.5","3060","4573","2410","650","2012","775000"
"4","2.5","2810","11902","2810","0","1993","747500"
"4","2.75","3090","7650","2340","750","1959","734000"
"3","2.75","2770","10000","1640","1130","1962","678000"
"3","2","2300","5000","1150","1150","1938","650000"
"4","2.5","2290","10186","2290","0","1985","650000"
"5","3.25","3990","13087","2400","1590","1991","649000"
"4","2.75","3130","9711","3130","0","2014","649000"
"3","2.5","2350","4166","2350","0","1966","643403"
"3","1.75","1610","3210","910","700","1928","626500"
"4","2","2190","3622","1990","200","1925","625000"
"4","3.25","2810","11250","1680","1130","1980","624000"
"4","2.5","2720","34498","1360","1360","1966","620000"
"3","2.5","1910","4488","1910","0","1998","617000"
"4","2.5","2410","7140","2410","0","1993","608000"
"4","2.75","2240","208652","1540","700","1940","590000"
"4","2.5","1950","3720","1950","0","2004","585000"
"4","3","1670","1189","1427","243","2000","582000"
"4","2.75","3140","10918","1900","1240","1968","570000"
"5","2.75","2920","6327","2920","0","2007","562500"
"4","2.75","2170","7140","1290","880","1977","555000"
"4","2.5","2470","7539","2470","0","2006","550000"
"3","2.5","1990","15985","1540","450","1964","542000"
"4","2.5","2020","3440","1480","540","1928","542000"
"3","1.5","1950","1963","1950","0","2002","530000"
"2","1.5","1620","1444","1080","540","2007","525000"
"4","1.5","1580","6360","1290","290","1945","525000"
"6","2","2390","8660","2390","0","1925","516250"
"2","2","1560","4675","1560","0","2006","509000"
"3","2.5","2400","9601","1390","1010","1977","505000"
"3","1.75","1770","7875","1170","600","1958","502550"
"3","3.5","1820","1991","1430","390","2014","499950"
"3","2.5","1910","5600","1910","0","1989","498688"
"3","2.25","1820","13362","1220","600","1977","480000"
"5","2.5","2300","28480","2300","0","1994","475000"
"3","2.25","1190","1137","960","230","1999","475000"
"4","2.5","2440","5001","2440","0","2005","455000"
"3","2.5","2210","8010","2210","0","1998","445000"
"3","1.5","1740","6988","1600","140","1950","435000"
"4","2.75","2290","5249","2290","0","2003","430000"
"3","1.75","1230","10005","1230","0","1963","420000"
"4","2","2090","4000","1060","1030","1907","417000"
"5","2.75","2400","15781","1200","1200","1974","406550"
"3","2.5","1970","12205","1970","0","1990","402000"
"3","2.5","1610","3755","1610","0","1987","395000"
"2","1","980","3350","980","0","1925","393000"
"3","2.5","1700","6396","1700","0","2003","389950"
"3","2","1150","6249","1150","0","1952","382500"
"4","1.75","2030","12518","1610","420","1950","380000"
"2","1","1040","4172","1040","0","1946","370000"
"3","1.75","1960","7705","980","980","1950","355000"
"3","1","1720","16552","1720","0","1971","354900"
"4","2.5","2900","4762","2900","0","2005","354000"
"3","3.25","1600","1298","1600","0","1999","350000"
"3","2.25","1840","9929","1200","640","1987","350000"
"4","1.75","2240","7500","1120","1120","1956","344950"
"4","1.75","1670","9472","1100","570","1960","335000"
"3","1","2130","3825","2130","0","1917","335000"
"4","2.5","1930","8458","1930","0","1993","325000"
"4","2.75","2090","9240","2090","0","1949","325000"
"2","1","1000","5120","1000","0","1902","317500"
"4","2.75","2300","18360","1560","740","1979","315000"
"4","2.5","2740","8400","2740","0","1993","315000"
"2","1","840","10465","840","0","1951","295000"
"4","1.75","2140","8162","1420","720","1968","292500"
"4","2.25","1890","7616","1260","630","1979","291000"
"4","2.25","1900","10950","1400","500","1959","290000"
"1","0.75","740","1284","740","0","1928","290000"
"3","1.5","1240","9125","1240","0","1967","275000"
"3","2","1810","7209","1240","570","1978","260000"
"4","1.75","1650","7276","1010","640","1977","260000"
"4","1.5","1260","7248","1260","0","1955","259000"
"3","1.75","1530","14087","1070","460","1979","257500"
"2","1.5","1280","8710","1280","0","1967","252500"
"2","1","1120","5650","720","400","1904","245000"
"3","2.5","1720","3407","1720","0","1992","245000"
"4","2.5","2300","15188","2300","0","1966","243500"
"3","2.25","1770","10000","1340","430","1978","242500"
"3","2.5","1520","9864","1160","360","1993","240000"
"3","1.75","1310","18400","870","440","1954","234500"
"3","1","1640","7187","1640","0","1966","230000"
"3","1.5","1670","8230","1670","0","1954","227950"
"2","1","990","57499","990","0","1949","220500"
"3","1.5","1270","7128","1270","0","1954","212500"
"4","1","1760","8906","1230","530","1966","185000"
"4","1","1210","6250","1210","0","1962","175000"
"3","1","1640","13939","1040","600","1960","170500"
"3","2.25","1470","8682","1160","310","1985","160000"
"2","1","790","7275","790","0","1944","150000"
"4","3.5","3845","8400","3845","0","2013","1750000"
"4","2.25","3180","6105","3180","0","1905","1320000"
"4","3.25","3160","10043","3160","0","2011","1250000"
"3","1.75","2550","6117","1650","900","1951","1190000"
"4","2.5","2110","10100","2110","0","1968","981000"
"3","2.5","2260","9577","1700","560","1925","900000"
"2","1.75","2170","7089","2170","0","1952","850000"
"4","1","2290","6300","2150","140","1921","825000"
"4","3.5","3650","57538","3650","0","1996","824000"
"6","4.5","4000","7500","4000","0","1978","739000"
"5","4.25","4110","42755","2970","1140","2000","734000"
"2","1.5","1790","4250","920","870","1915","721000"
"3","2.5","2890","7027","2890","0","2004","715000"
"3","2.5","2820","7200","1780","1040","1979","705000"
"3","1.75","1650","8400","1470","180","1959","685000"
"3","1.75","2330","9652","1590","740","1968","680000"
"3","1.5","2510","3600","2510","0","1907","675000"
"4","2.75","2420","7102","1670","750","1946","665000"
"4","2.25","2200","8000","1430","770","1971","655000"
"5","3.5","5110","10018","3850","1260","2003","650000"
"4","2.25","2130","11900","2130","0","1976","649990"
"4","2.5","2970","34981","2970","0","1998","640000"
"4","1.5","2190","13660","2190","0","1952","625000"
"5","4.5","4440","5562","4440","0","2012","600000"
"3","3","3030","35123","1760","1270","1984","599900"
"4","2.5","2280","2432","1520","760","1921","597000"
"4","2.25","1780","6120","1310","470","1951","587500"
"3","2","2168","4000","2168","0","1907","575000"
"2","1","1230","2726","880","350","1920","575000"
"4","2.75","2170","5988","2170","0","2014","551000"
"3","2.5","2360","4080","2360","0","2003","550000"
"1","1","2880","7560","1440","1440","1925","550000"
"4","3","4180","35169","4180","0","1986","550000"
"5","3","3800","42316","3800","0","1984","549900"
"3","2.25","2290","14585","2290","0","1981","545000"
"2","1","890","3060","770","120","1910","542000"
"4","2","1720","6413","860","860","1950","537000"
"4","3","2190","5085","2190","0","1992","520000"
"3","2.5","1730","4924","1730","0","1996","480680"
"2","1","1010","3400","1010","0","1921","470450"
"4","2.5","2090","7241","1140","950","2001","469500"
"4","2.25","2100","7350","2100","0","1979","465000"
"3","2.5","2390","47480","2390","0","2007","460000"
"3","1","1310","7000","1310","0","1958","447000"
"3","2","1460","2610","1460","0","1987","444000"
"4","2.5","2598","5553","2598","0","2014","428900"
"2","1","2110","4920","1460","650","1911","425000"
"2","2.5","1340","1263","1340","0","2008","425000"
"2","1.5","1660","4000","1000","660","1950","410000"
"2","1.75","2320","6250","1400","920","1948","400950"
"4","2.5","2170","204296","2170","0","1980","400000"
"1","1","530","13679","530","0","1949","400000"
"3","1.5","2390","32109","2390","0","1975","400000"
"2","2","1300","3865","1300","0","2006","398000"
"4","1.75","1910","8117","1460","450","1975","395000"
"3","2","1710","8910","1710","0","1953","390000"
"4","3","2860","5724","1730","1130","1983","390000"
"3","1","1220","8329","1220","0","1946","387500"
"3","2","1360","4840","1360","0","1936","382000"
"3","1.5","1560","6774","1060","500","1927","370000"
"2","2.25","1280","2574","1280","0","1992","364000"
"3","2.25","1381","1180","1381","0","2007","360000"
"5","2.25","2450","9432","2450","0","1973","359950"
"4","3.5","2770","8763","2100","670","1996","359000"
"3","2","1010","21340","1010","0","1980","354000"
"4","2.75","1920","4627","1010","910","1998","353000"
"4","1","1550","7260","1550","0","1959","351000"
"2","2.5","2550","216344","2550","0","1993","345000"
"3","1.75","1790","5120","940","850","1949","335000"
"4","2","1780","10622","900","880","1976","325000"
"4","2.75","2110","13260","1290","820","1979","320000"
"4","2","2020","7767","2020","0","1995","315000"
"4","2.5","1850","7199","1850","0","1989","305500"
"2","1","670","6720","670","0","1942","304950"
"5","2","1540","9629","1540","0","1960","302000"
"3","2.5","1560","5845","1560","0","2003","296000"
"3","1","1210","33919","1210","0","1954","290000"
"3","2","1850","9550","1850","0","1988","289000"
"3","1.75","2630","6500","1330","1300","1958","280000"
"3","1","1720","9605","860","860","1969","280000"
"3","2.5","1600","7936","1600","0","1996","280000"
"3","2.5","1730","5799","1730","0","1987","275000"
"4","1.75","2210","6375","1640","570","1977","263500"
"3","2.25","1810","12000","1810","0","1992","257000"
"2","1.75","1840","7230","1570","270","1938","245000"
"2","1.75","1300","14500","650","650","1939","244500"
"3","1.75","1470","8925","1470","0","1957","239000"
"5","2.75","2000","5885","1260","740","1994","229950"
"3","1","1140","7560","1140","0","1958","218000"
"3","1.75","1100","9750","1100","0","1967","212000"
"4","2","1260","8400","1260","0","1991","207200"
"2","1.75","1330","2159","1330","0","1979","202200"
"3","1.75","1330","16000","1330","0","1978","180000"
"3","1.75","1230","12000","1230","0","1970","179900"
"3","1","760","3090","760","0","1903","167500"
"3","1","890","9465","890","0","1957","154500"
"3","1","1200","7000","1200","0","1908","130000"
"2","1","810","8382","810","0","1942","125000"
"3","1","1080","6250","1080","0","1950","115000"
"4","3","3260","4500","2300","960","1930","1280000"
"3","2.5","3110","9930","1640","1470","1954","1260000"
"3","2.5","3780","35273","3780","0","1986","930000"
"5","2.75","2460","7830","1490","970","1955","835000"
"4","2.5","2270","5000","2270","0","2014","812000"
"4","3.5","3680","2242","2670","1010","1930","770000"
"2","1.5","1300","7632","1300","0","1943","750000"
"3","2","1610","3600","1610","0","1925","735000"
"3","3","3460","13129","2560","900","1988","730000"
"3","2.5","3570","35271","3570","0","1997","725000"
"4","2.25","2530","9870","1530","1000","1957","720000"
"4","2.75","2510","12500","2050","460","1976","704000"
"4","1.5","2270","6010","1290","980","1954","676101"
"4","2.5","2390","8432","2390","0","1998","664000"
"4","2.5","2820","15000","2820","0","1985","650000"
"4","2.5","2280","9827","2280","0","1995","649800"
"2","2","1540","6804","1020","520","1942","582500"
"3","3","2400","5500","2400","0","1991","570000"
"3","2.5","1930","5080","1930","0","1990","533600"
"3","1.75","1620","3360","980","640","1927","532500"
"2","1","1510","4000","930","580","1924","500000"
"3","1.5","990","1343","840","150","2007","490000"
"4","2.5","3250","13360","3250","0","2014","486940"
"3","1.75","2600","105587","1300","1300","1980","482000"
"3","2","1820","1358","1820","0","2014","479950"
"3","2","1750","4990","950","800","1916","477000"
"4","2.5","3050","32450","1550","1500","1983","465000"
"3","1","1100","145490","1100","0","1915","465000"
"4","2.5","2800","6567","2800","0","2006","459950"
"3","2.25","1660","10247","1130","530","1968","450000"
"3","2.25","1190","13630","1190","0","1984","445000"
"3","2.5","2600","4724","2600","0","2002","444500"
"5","3","2730","6000","1470","1260","1979","440000"
"1","1","790","2400","790","0","1918","439000"
"4","2.5","2480","4504","2480","0","2005","425000"
"2","1","1190","5100","1190","0","1928","417000"
"4","3.5","3040","7125","2240","800","2002","415000"
"3","2.5","1790","3754","1790","0","2013","414000"
"2","1","740","6380","740","0","1912","407000"
"4","1.5","2150","11026","2150","0","1952","400000"
"3","1","860","9403","860","0","1942","399000"
"2","1","1120","8661","1120","0","1946","399000"
"5","2.5","2340","5670","2340","0","2009","392000"
"3","1","1150","10196","1150","0","1957","383000"
"3","1.5","1200","8560","1200","0","1975","370900"
"3","2.5","1360","3718","1360","0","1987","369950"
"3","1.75","1650","11220","1650","0","1969","361000"
"4","2.25","3220","7700","3220","0","1976","359999"
"4","1.75","1580","6396","790","790","1945","359000"
"4","2.5","2770","7000","1940","830","1979","355000"
"4","1.75","1820","7700","1100","720","1955","344900"
"3","1","1400","5662","1400","0","1920","343000"
"3","1.75","1210","9635","1210","0","1987","340000"
"3","1","1350","14212","1350","0","1981","335000"
"3","1.5","2580","47480","1360","1220","1953","332220"
"3","2.5","1520","3003","1520","0","2009","330000"
"4","1","1360","8136","1360","0","1948","328000"
"3","2.5","1880","6818","1880","0","1993","325000"
"4","2.25","2130","8499","1600","530","1975","325000"
"3","1.75","1510","30185","1510","0","1976","320000"
"4","1","1730","36356","1730","0","1954","319000"
"3","1","960","8556","960","0","1971","319000"
"3","2.5","1800","2516","1800","0","2001","285000"
"3","2.5","1480","7210","1180","300","1986","276200"
"4","2.5","2050","12500","1300","750","1965","260000"
"3","2","1140","7078","1140","0","1991","257500"
"5","3.75","2800","9900","2800","0","1964","255000"
"5","1.75","2320","7700","1290","1030","1962","250000"
"3","1.5","1550","9126","1550","0","1957","245000"
"4","1.75","1880","9600","1020","860","1946","240000"
"3","1","1300","5898","1300","0","1961","236000"
"3","1.5","1510","10588","1510","0","1947","230000"
"3","1","900","6099","790","110","1944","225000"
"2","1.75","2040","8600","1430","610","1985","210500"
"2","1","880","9750","880","0","1938","210000"
"3","1","1400","7955","1400","0","1964","194000"
"3","1","1280","4875","1280","0","1969","180000"
"2","1","740","3434","740","0","1920","175000"
"4","1","1520","7298","1520","0","1960","160000"
"7","3","5350","14400","5020","330","1910","2890000"
"5","3.75","3570","10125","3570","0","2014","1600000"
"4","3.5","3500","9525","3500","0","1999","1350000"
"3","3","4610","8400","2790","1820","1947","1250000"
"4","2","3090","8125","3090","0","1918","1220000"
"4","2.5","3470","10045","3470","0","1993","920000"
"4","3.25","4060","52707","4060","0","1996","880000"
"3","2.5","2950","35108","2950","0","1995","820000"
"4","3.5","3320","8808","3320","0","2005","786000"
"4","2.5","3890","34513","3890","0","1996","775000"
"2","1.75","1660","4000","990","670","1940","765000"
"4","2.75","3190","5408","3190","0","2005","722000"
"4","2","1740","9000","1740","0","1958","710000"
"4","2.75","3220","4000","3220","0","1993","689000"
"4","2.5","2020","9600","2020","0","1954","689000"
"4","2.5","3030","13068","3030","0","1978","680000"
"4","2.25","2290","9546","1780","510","1976","668500"
"3","1.75","1900","3783","1110","790","1927","615000"
"5","3.5","3580","5562","2140","1440","1937","600000"
"2","1","1550","7713","1550","0","1930","599000"
"3","2.25","2520","12000","2520","0","1978","598500"
"3","3","2840","7201","2840","0","2014","589410"
"4","1.75","2270","27122","1300","970","1957","585000"
"5","2.75","1940","5000","1940","0","1951","577000"
"4","2.5","2630","6247","2630","0","1992","575000"
"4","1.75","1860","7700","1860","0","1964","570000"
"4","1","1960","3194","1960","0","1907","569500"
"4","1.75","1230","7890","1090","140","1950","569000"
"4","2.5","2330","7936","2330","0","1987","565000"
"3","2.5","3440","103672","3440","0","1990","560000"
"3","2","2870","95396","1350","1520","1980","560000"
"3","2.5","1790","4038","1790","0","2005","541000"
"3","1.75","1520","7875","1520","0","1969","525000"
"4","1","1570","4000","1570","0","1920","525000"
"4","2.5","2835","6598","2835","0","2002","522000"
"2","3","2770","10800","1910","860","1984","505000"
"4","2.25","2270","8196","1150","1120","1963","500000"
"3","2.5","1750","2150","1230","520","1900","499000"
"3","2","3000","21883","1970","1030","1998","490500"
"4","2.5","3000","8645","3000","0","1985","490000"
"3","2.75","2770","54707","2370","400","1938","470000"
"3","1.75","1300","4000","900","400","1953","460000"
"3","2.5","2620","14096","2620","0","1989","450000"
"3","2.5","2820","10208","1410","1410","1954","450000"
"3","2","1500","8086","1060","440","1981","425000"
"2","2","1280","4095","1280","0","1918","425000"
"2","1","880","4558","880","0","1951","415000"
"3","1","1120","8321","1120","0","1941","401000"
"2","2.25","1620","1841","1540","80","2004","395000"
"2","1","1050","4125","1050","0","1909","392500"
"4","2.5","2570","22215","2570","0","1958","390000"
"3","2.5","1580","3825","1580","0","2011","375000"
"3","2","1340","1480","1340","0","1997","369000"
"3","2.5","1780","1754","1780","0","2007","365000"
"3","1","1600","4489","800","800","1944","364500"
"2","1.75","1230","1107","1230","0","2006","360000"
"3","2","2160","8091","2160","0","2000","355000"
"4","2.25","1800","2752","1800","0","2014","352800"
"4","1","1010","6000","750","260","1925","350000"
"3","1","1180","7455","1180","0","1964","350000"
"4","2.5","2500","5831","2500","0","2007","350000"
"4","2.5","2030","4596","2030","0","2014","349500"
"4","2.5","2100","7366","2100","0","1997","333000"
"3","1.75","1590","9417","1590","0","1954","330000"
"3","2.25","1800","9597","1200","600","1963","319000"
"3","1","1010","7838","1010","0","1977","316000"
"3","1","820","5150","820","0","1918","305000"
"3","1.5","1500","14750","1500","0","1933","300000"
"4","2.5","1950","3000","1950","0","2002","299000"
"4","2.25","1870","6693","1870","0","1996","299000"
"3","1","1320","9520","990","330","1953","294000"
"4","1.5","1480","47045","1480","0","1942","283000"
"4","2.5","2400","4596","2400","0","2004","280000"
"2","1","1020","47044","1020","0","1904","279000"
"4","2.5","2070","6175","2070","0","1993","272000"
"3","2.5","1700","6200","1700","0","1997","262000"
"3","1","1040","8410","1040","0","1942","245990"
"3","2","1220","17652","1220","0","1980","240000"
"3","2","1030","11118","1030","0","1970","240000"
"3","2.25","1410","7290","940","470","1980","240000"
"3","1","960","5030","960","0","1955","235000"
"3","1.75","1290","6604","1290","0","1984","232000"
"3","1","940","10875","940","0","1957","230000"
"4","2","1620","5200","1620","0","1978","220000"
"3","2.5","1600","2231","1600","0","2003","214000"
"3","2","1310","7000","1310","0","1979","196500"
"3","1","1060","7350","1060","0","1959","182000"
"2","1","870","6537","870","0","1948","170000"
"3","1","910","7686","910","0","1969","169000"
"3","2","1520","7456","1520","0","1949","167000"
"4","2.75","4910","15139","2560","2350","1964","1540000"
"4","3.5","2850","4416","2040","810","1926","875000"
"4","2.75","3150","6343","1810","1340","1976","750000"
"2","1","1760","27332","1300","460","1951","500000"
"3","2","1780","8621","1780","0","1992","406500"
"4","2.75","2810","5046","2810","0","2014","531155"
"4","2.5","2230","5650","2230","0","2011","440000"
"3","1.75","1690","7953","1690","0","1986","259900"
"4","5.5","6930","45100","4310","2620","1950","2530000"
"4","2.5","3650","8354","1830","1820","2000","2400000"
"4","1.5","2650","6900","2400","250","1909","1460000"
"4","2.75","3200","13729","3200","0","1984","1270000"
"4","2","2970","5400","2970","0","1900","1260000"
"3","2.25","3250","34848","2260","990","2006","1150000"
"5","3.5","4280","6530","4280","0","2014","1140000"
"3","2.5","4110","35741","4110","0","1976","1030000"
"4","2.5","3570","6054","3570","0","2014","928990"
"5","3.5","3870","65556","3870","0","1994","850000"
"4","2.5","3180","11652","3180","0","1977","850000"
"5","2","1720","9972","1720","0","1951","845000"
"5","2.25","2060","4800","2060","0","1907","815241"
"4","2.5","2760","13093","2760","0","1989","745000"
"3","3.5","2420","4000","1820","600","1907","740000"
"4","3","2420","12000","2420","0","1984","725000"
"4","2.75","2210","3400","1470","740","1926","719000"
"6","2.5","2680","11250","1340","1340","1967","698000"
"4","3.5","3530","7202","2660","870","2000","695000"
"4","2.5","2820","8307","2820","0","1990","690000"
"4","2.5","3860","5130","2930","930","2004","681000"
"4","2.25","2590","8190","2590","0","1980","673000"
"4","2.5","2500","6005","2500","0","2001","650000"
"3","2.5","2220","6380","1660","560","1931","650000"
"3","2.75","1670","1350","1350","320","2014","649950"
"4","1.75","1350","9293","1350","0","1954","626000"
"2","1","1520","5400","920","600","1951","619950"
"3","2.25","2320","38186","2320","0","1980","610000"
"4","4.75","3700","11000","1840","1860","1962","599000"
"4","2.25","2610","7700","1700","910","1977","580000"
"2","1.75","970","4233","970","0","1944","560000"
"3","2","2240","11250","2240","0","1968","555000"
"3","3.5","2100","2479","1450","650","2011","555000"
"3","2.25","2160","37000","1760","400","1933","550000"
"3","2","3650","843309","3650","0","1991","550000"
"4","1.5","1520","5910","1020","500","1946","546800"
"4","2.5","2470","5044","2470","0","2005","503000"
"4","2.5","2460","4774","2460","0","2006","495000"
"4","2.5","1800","4500","1800","0","1999","485500"
"3","1.75","2260","8512","1130","1130","1948","467500"
"4","2.5","3284","6516","3284","0","2014","460458"
"2","1","1030","5000","1030","0","1917","455000"
"4","2.25","2460","14600","1720","740","1977","439950"
"3","2.5","1730","46638","1730","0","1991","435000"
"3","1","970","8040","970","0","1956","425000"
"4","1.75","1730","11890","980","750","1955","425000"
"2","2.5","1320","1329","1180","140","2007","425000"
"3","1.75","1140","3395","620","520","1925","424000"
"2","1","880","6650","880","0","1918","416000"
"5","3","2420","7740","1360","1060","1929","411500"
"2","2.5","1790","5400","1790","0","1979","405000"
"4","2.5","2130","11733","1330","800","1969","395000"
"4","2.5","2090","5040","2090","0","2014","388000"
"3","1","1420","10980","1200","220","1954","385000"
"4","2.5","2380","4913","2380","0","2006","384950"
"2","2","2160","35183","2160","0","1985","381500"
"4","2.5","2540","6688","2540","0","2002","365000"
"4","2.25","2470","8686","1270","1200","1974","360000"
"4","1.75","2040","10800","1360","680","1967","355000"
"4","2.5","1820","3134","1820","0","1999","349950"
"3","2","2360","6145","2360","0","2011","348000"
"1","1","640","4800","640","0","1918","340000"
"2","1","710","5200","710","0","1942","320000"
"3","1","1070","9497","1070","0","1955","315000"
"4","2.5","2390","9600","2390","0","1996","314500"
"4","1","1560","8450","1560","0","1954","305000"
"3","1","1120","10701","1120","0","1954","285000"
"3","1.75","1670","6034","990","680","1957","280000"
"3","1","1230","171190","1230","0","1973","275000"
"4","2.75","2440","7150","1200","1240","1963","270000"
"4","1","1640","8467","1220","420","1943","261490"
"3","2.5","1427","4337","1427","0","2009","260000"
"2","1","790","8100","790","0","1947","259950"
"5","1.75","1970","8925","1170","800","1977","255000"
"3","1","1160","8636","1160","0","1923","255000"
"3","1.75","1570","7416","1570","0","1971","253000"
"3","2.5","1730","7442","1730","0","1987","245000"
"4","2.5","2040","11841","2040","0","1994","240000"
"2","1","960","8100","810","150","1936","232000"
"3","2","1640","4875","1040","600","1977","231000"
"3","2.25","1690","7245","1160","530","1973","230500"
"3","1","920","5546","920","0","1928","207000"
"3","1","860","33664","860","0","1955","199129"
"7","4.25","4670","23115","4670","0","1992","2450000"
"4","2.5","2720","10455","2500","220","1981","975000"
"3","1.5","1790","7526","1790","0","1953","865000"
"4","2.75","5440","239580","2720","2720","1969","850000"
"3","2","1420","4080","1420","0","1904","764000"
"4","2.5","2630","4000","2630","0","2002","655000"
"4","2.5","2540","11100","2540","0","1957","630000"
"3","2.5","2160","1912","1970","190","2014","629000"
"3","2.75","2810","12813","2040","770","1988","607000"
"3","2.5","1620","1171","1470","150","2008","580000"
"3","2.5","2120","4780","2120","0","2004","575000"
"2","2.25","1160","954","960","200","2014","555000"
"3","2.25","1230","1380","1230","0","2013","549000"
"4","2.25","2380","5250","1410","970","1961","527000"
"5","1","1280","3876","1280","0","1923","525000"
"2","1","910","5000","910","0","1924","520000"
"4","2.5","1560","12220","1560","0","1965","511100"
"3","1","2090","4755","1200","890","1969","478500"
"5","2.25","1780","7245","1330","450","1976","472000"
"5","2","1220","13457","1090","130","1921","469950"
"3","3.25","1390","1278","1140","250","2005","469000"
"1","1","1090","990","1090","0","1924","463500"
"2","2","1690","4200","1690","0","1906","462500"
"2","1.75","1350","50965","1350","0","2004","455000"
"2","1","1030","4365","1030","0","1942","450000"
"3","2.5","2360","6699","2360","0","2003","430000"
"2","2.25","1040","1516","1040","0","2008","430000"
"3","1.75","1960","43332","1400","560","1982","425000"
"4","2.5","2891","6499","2891","0","2014","415000"
"4","1.75","2020","14258","1620","400","1959","397000"
"4","2.5","2980","8786","2980","0","2003","382500"
"3","2.25","2110","13300","2110","0","1985","370000"
"4","2.5","1770","9239","1770","0","2004","353500"
"3","1","1300","10236","1300","0","1971","350000"
"3","2","1470","6950","1470","0","1932","344950"
"3","3","1260","1251","1040","220","2003","342000"
"3","1.5","1430","8000","1430","0","1948","330000"
"4","2.75","2475","4000","2475","0","2014","329900"
"5","2.75","2570","7260","2570","0","1996","329000"
"3","1.75","1710","15844","1710","0","1964","322400"
"3","1.75","2200","12231","1250","950","1964","322000"
"3","1","1160","10500","1160","0","1966","315500"
"2","1","860","12160","860","0","1921","310000"
"4","2.25","2080","7700","1450","630","1968","300000"
"3","1.5","1220","3286","1220","0","1982","295000"
"3","1.5","1030","7184","1030","0","1968","275000"
"4","1.75","1490","9112","970","520","1940","271000"
"3","1.5","910","25500","910","0","1943","255000"
"3","1","940","8400","940","0","1958","253905"
"2","1","820","7475","820","0","1945","245000"
"3","1.75","1200","9266","1200","0","1960","235000"
"1","1","820","1060","760","60","2007","219500"
"3","1.5","1830","12233","1830","0","1930","212000"
"2","1","920","2332","920","0","1980","176000"
"3","0.75","1040","42180","1040","0","1947","170000"
"4","3.25","4280","20296","4280","0","1984","1930000"
"3","3.25","5290","224442","4540","750","1988","1690000"
"5","3.5","5170","7197","3520","1650","1998","1680000"
"4","2.75","3680","5000","2480","1200","1936","1600000"
"4","3.25","3730","7200","2810","920","2006","1490000"
"4","3.25","2470","4760","1890","580","1906","1330000"
"3","2.25","2360","5504","2080","280","1913","1330000"
"4","3.25","4360","6000","3400","960","2007","1260000"
"3","2.5","2510","5432","2510","0","2006","1190000"
"3","1.75","1640","10464","1640","0","1968","1160000"
"4","3.5","4460","16271","4460","0","2001","1060000"
"4","3","2990","6695","2990","0","2014","1060000"
"4","2.5","2700","4590","2700","0","2002","1020000"
"2","1","1570","4400","1570","0","1914","998500"
"4","3.5","4370","422967","2580","1790","1978","858000"
"4","1.5","2440","8040","1440","1000","1950","849000"
"4","2.5","3520","15420","3520","0","1991","810000"
"4","2.5","3230","4290","3230","0","2004","772500"
"3","1.75","1900","6334","1450","450","1948","770000"
"3","1.5","1980","5800","1520","460","1949","759000"
"3","2.5","2930","5641","2930","0","2013","754842"
"2","2","1650","6840","1650","0","1916","705000"
"2","1","1370","5922","1130","240","1941","703011"
"4","1.5","1970","4590","1970","0","1909","690000"
"3","2.75","1930","2960","1490","440","1929","665000"
"3","1.75","1750","5200","1750","0","1956","660000"
"3","1","1370","5250","1070","300","1939","655000"
"4","2.5","3340","34238","2060","1280","1977","655000"
"3","1","1010","6000","1010","0","1919","636100"
"4","1","1560","4080","1560","0","1923","627500"
"3","1.75","1660","4800","1660","0","1906","625000"
"3","1.5","1600","4128","1250","350","1906","625000"
"4","4","2850","2970","2120","730","1999","620000"
"3","2.5","1700","1156","1320","380","2002","585000"
"4","1.75","2340","5080","1170","1170","1924","570000"
"3","2.5","2150","8060","2150","0","1995","569000"
"2","1.75","1900","209088","1200","700","1919","539000"
"4","3.5","2734","210201","2734","0","1974","520000"
"3","2.25","2750","54014","1870","880","1981","510000"
"3","2.25","1530","1396","1240","290","2007","500000"
"3","1.75","2080","3000","1040","1040","1925","495000"
"2","2","1200","1867","600","600","1924","478000"
"4","1.75","1730","11700","880","850","1956","465000"
"3","2.5","1530","5032","1530","0","1998","452000"
"3","2.5","2530","8116","2530","0","2001","450000"
"3","2.5","2410","4293","2410","0","2007","450000"
"2","1","1190","3400","990","200","1917","440000"
"3","2.25","1230","1097","1230","0","2009","440000"
"2","1","800","5100","800","0","1945","439000"
"3","2.25","1800","6680","1800","0","1983","436000"
"2","2.75","1992","10946","1288","704","1903","429592"
"2","1.5","1440","6460","1100","340","2011","427000"
"3","1","1790","6000","1790","0","1937","425000"
"3","1","1830","13900","1830","0","1951","423000"
"3","1.5","990","4500","990","0","1948","421500"
"3","2.5","1440","3060","1440","0","2003","421200"
"3","1.5","1130","5413","940","190","1946","420000"
"2","1","1040","5120","1040","0","1901","412000"
"3","2.5","1200","813","1200","0","2010","412000"
"5","2.5","2740","12413","2740","0","1990","386000"
"4","2.5","2250","5306","2250","0","2012","375000"
"2","1","1070","2196","880","190","1917","346000"
"3","2.5","2690","8577","2690","0","1987","340000"
"4","2.5","2154","6050","2154","0","2012","335000"
"2","1","1160","32251","580","580","1963","330000"
"3","1","1400","9000","1400","0","1959","320000"
"4","2.25","2180","10754","1100","1080","1954","315000"
"4","2.5","2040","6300","2040","0","2003","315000"
"3","1.75","1490","9120","1490","0","1959","310000"
"3","2","1680","8487","1680","0","1993","305000"
"3","3","1290","1112","1290","0","2008","305000"
"3","2.5","1210","2046","920","290","2008","299900"
"3","2.5","1460","7936","1460","0","1995","295000"
"4","2.25","2190","3746","2190","0","2005","294000"
"3","1","1250","26862","1250","0","1965","287000"
"4","2.75","2130","8560","1560","570","1992","283000"
"3","1","1740","5247","1270","470","1947","283000"
"4","1","1880","6288","1120","760","1974","280000"
"4","1","1860","8505","1860","0","1955","265000"
"3","1.5","1610","10291","1610","0","1961","262500"
"4","2","1650","5974","860","790","1972","251000"
"3","1.5","1140","10300","1140","0","1967","234000"
"2","1","860","6800","860","0","1943","227000"
"3","1.5","1860","8505","1860","0","1967","217000"
"2","1","830","6000","830","0","1940","210000"
"2","1","760","6141","760","0","1920","162500"
"5","3.25","5790","12739","4430","1360","2014","1750000"
"4","3.5","3930","6120","3310","620","2007","1490000"
"4","2.5","3470","4160","2480","990","1927","1300000"
"4","3.5","3040","4006","2350","690","2013","815000"
"7","2.25","3260","8145","3260","0","1967","770000"
"4","2.75","3190","9023","3190","0","2005","750000"
"4","2.25","3440","14237","3440","0","1982","725000"
"6","2.75","2830","10579","1430","1400","1967","705000"
"4","2.75","1660","5150","1280","380","1928","685000"
"4","2.5","3110","24466","3110","0","1997","655000"
"3","2","2130","5000","1330","800","1925","652000"
"4","1","1260","4080","1260","0","1911","618000"
"3","2.5","3370","14402","3370","0","2004","595000"
"3","2.5","1740","2350","1130","610","1995","585000"
"4","3","3280","11060","2270","1010","1986","580000"
"4","2.75","2770","3852","2770","0","2014","572000"
"3","2.5","1960","47044","1960","0","1978","535000"
"5","2.25","3030","9430","2600","430","1961","529900"
"4","2.5","2520","7731","2520","0","1994","525000"
"4","2.75","2530","17856","2530","0","1998","525000"
"4","2.75","2530","11549","1700","830","1942","525000"
"3","1.75","2120","9146","1260","860","1981","525000"
"4","2.75","2730","9112","1740","990","1996","510000"
"2","1","1670","14695","1670","0","1930","495000"
"4","4.25","4480","5715","3680","800","2003","490000"
"4","1","1620","4080","1620","0","1923","485000"
"3","2.25","2130","8801","1370","760","1976","482975"
"4","1.75","1920","9380","1920","0","1964","480000"
"4","3.5","2870","3225","2070","800","2006","460000"
"4","1.5","2220","12385","1270","950","1978","456000"
"3","2.25","1260","2556","1260","0","2005","449500"
"4","2.25","2670","14255","1610","1060","1975","437850"
"3","1.75","1830","9758","1300","530","1977","429950"
"3","1.75","2120","9350","1280","840","1979","428000"
"3","2.5","2340","3466","2340","0","2004","428000"
"2","1","1170","5000","1030","140","1920","425000"
"5","2.5","1980","10205","1080","900","1929","418000"
"2","1.5","1170","1274","1170","0","2001","405000"
"3","1","900","4084","900","0","1910","400000"
"3","3.25","1380","1234","1380","0","2006","379000"
"2","1.5","1130","912","1000","130","2006","375000"
"3","2.5","1790","4065","1790","0","2009","366000"
"3","1.75","1120","7740","860","260","1948","355000"
"3","1.75","2190","7021","1390","800","1953","353000"
"4","2.5","2150","5100","1290","860","1991","346500"
"4","1.75","1680","15084","840","840","1979","340000"
"4","2.5","1930","7862","1930","0","1994","339500"
"3","2.5","1570","2865","1570","0","2003","315000"
"3","2","1290","6150","1290","0","1950","310000"
"3","1.75","1680","8629","1200","480","1977","308000"
"2","2.25","1320","1034","1320","0","1996","304000"
"4","1","1730","177657","1730","0","1948","300000"
"4","2.25","2050","169448","2050","0","1977","299000"
"3","2.5","1270","1283","1270","0","2007","292000"
"3","1","1810","7200","1130","680","1954","287500"
"3","1.75","1100","1307","780","320","2008","285000"
"3","2.5","1660","4083","1660","0","2013","284000"
"3","1.75","2080","87991","1040","1040","1970","280000"
"4","1","1430","27153","1430","0","1934","275000"
"4","2.5","1900","8282","1900","0","1968","270000"
"3","1.75","1980","12543","1180","800","1978","268000"
"3","1","1070","4800","970","100","1947","265000"
"3","2.5","1400","3368","1400","0","2013","265000"
"4","2.75","1830","7315","1250","580","1979","263000"
"3","2","1530","8749","1530","0","1995","247500"
"3","2","1700","8448","1700","0","1996","245000"
"5","2.25","2340","7494","1170","1170","1951","242000"
"4","2.25","1830","7614","1830","0","1991","240000"
"3","1","990","10125","990","0","1972","222500"
"4","2.75","1810","8677","1810","0","1962","208000"
"2","1","990","8760","990","0","1977","179000"
"2","1","1740","8100","1050","690","1947","173000"
"1","1","500","7440","500","0","1928","125000"
"4","3.25","3990","18115","3990","0","1989","2720000"
"4","3.5","4020","13515","4020","0","2001","1690000"
"5","4.5","5130","43123","5130","0","1996","1600000"
"4","1.75","3720","8448","1960","1760","1947","1280000"
"4","3.5","3560","6562","3560","0","2014","882990"
"3","1.5","2040","3960","2040","0","1928","857500"
"3","2.75","2660","10350","1330","1330","1971","851000"
"4","2.5","2660","5043","2660","0","2003","765000"
"3","1.75","2120","5000","1980","140","1920","765000"
"4","2.5","2850","12429","2850","0","2008","750000"
"3","1.75","2560","4800","1280","1280","1911","747000"
"5","2.75","2930","7663","2930","0","2013","718000"
"3","2.25","1920","9600","1560","360","1968","652000"
"4","2.5","1990","8034","1990","0","1989","639000"
"3","1.75","2410","35236","2410","0","1980","620000"
"4","3.25","5450","37058","5450","0","1984","610000"
"4","2.5","2420","5562","2420","0","2001","597400"
"3","3","2780","6000","2780","0","2013","594866"
"4","1.5","2080","4400","2080","0","1925","592500"
"4","2.5","2320","8721","2320","0","1991","562500"
"2","2","1400","1512","940","460","2006","553000"
"4","1.75","1840","4280","920","920","1918","540000"
"3","1.5","1310","2983","1170","140","1928","526500"
"4","2.5","3130","5795","3130","0","2008","525000"
"3","2.5","1480","1165","1480","0","2006","520000"
"4","2.75","2440","12051","1440","1000","1966","518000"
"4","2.75","2630","15000","1690","940","1976","500000"
"4","2.5","1850","1836","1600","250","2005","476100"
"3","1","1500","9416","1500","0","1952","475500"
"3","1.75","2290","44866","1390","900","1981","450000"
"4","2.5","2708","4772","2708","0","2014","436952"
"4","3.5","2584","5005","2584","0","2014","429900"
"3","1.75","2650","7500","1590","1060","1962","415000"
"2","1.5","1240","3873","860","380","1909","412000"
"3","2.25","1880","12473","1420","460","1958","399000"
"4","2.25","2680","35218","2680","0","1986","390000"
"4","2.5","2130","6003","2130","0","2003","381000"
"4","1.5","1430","7232","1430","0","1948","375000"
"3","2.5","2430","5000","2430","0","2001","372000"
"2","1","1390","2500","1390","0","1925","354000"
"4","2.75","2300","3175","1340","960","1966","350000"
"4","2.75","3390","16153","1970","1420","1961","350000"
"3","1","1030","7200","880","150","1948","335000"
"4","1","1480","6500","1480","0","1914","335000"
"3","1.75","1340","13115","1340","0","1978","332000"
"3","1.5","1270","1067","1270","0","2009","325000"
"4","1.75","1760","11180","1760","0","1968","320000"
"2","1","1050","8220","780","270","1947","310000"
"3","1.75","1720","6000","1000","720","1954","304000"
"2","1","820","288367","820","0","1930","295000"
"3","2.25","1500","7482","1210","290","1968","290000"
"3","1.5","1870","42070","1870","0","1953","285000"
"4","2","1720","5472","860","860","1923","275000"
"2","0.5","1180","7750","590","590","1945","273000"
"3","2","1610","8416","1610","0","1994","268000"
"3","1.5","1530","7500","1530","0","1986","265000"
"2","1","1410","5650","1410","0","1918","260000"
"2","1","780","8160","780","0","1953","254922"
"4","2","1500","7854","1500","0","1983","249900"
"3","1.5","1630","6625","980","650","1980","230000"
"2","1","750","6089","750","0","1937","213000"
"3","1","1000","5454","1000","0","1954","210000"
"3","1.75","1170","9085","1170","0","1967","185000"
"3","1","940","7125","940","0","1958","185000"
"3","1.5","1020","10152","1020","0","1959","165000"
"5","1.5","1710","8100","1710","0","1961","158550"
"1","0.75","840","7203","840","0","1949","124000"
"4","1.75","2100","6613","2100","0","1909","750000"
"2","1.75","1210","1189","1210","0","2014","351358"
"1","1","580","1799","580","0","1908","330600"
"3","1.75","1550","6225","1550","0","1949","199950"
"4","2.75","2040","8996","1260","780","1974","464625"
"3","1.75","1290","4000","1170","120","1943","250800"
"3","1","1300","8284","1300","0","1968","169575"
"4","3.25","4250","12281","3020","1230","1996","1620000"
"4","3","3720","5432","2720","1000","1905","1440000"
"5","3.5","4350","6218","3520","830","2007","1150000"
"6","3.75","4090","49542","3100","990","1984","1150000"
"6","4.25","3100","9378","3100","0","1978","1130000"
"4","3","2720","4800","1790","930","1928","1020000"
"4","2.5","3430","42775","3430","0","1992","829950"
"3","2.5","3400","38400","1870","1530","1955","825000"
"3","1.75","2080","5000","2080","0","1906","825000"
"4","2.5","3320","7429","3320","0","2014","799950"
"5","3.5","3290","5600","2670","620","2004","775000"
"3","2.5","3190","49137","3190","0","1988","760750"
"4","2.5","3200","36276","3200","0","1993","737500"
"4","3.5","4420","7902","3350","1070","2004","730000"
"4","2.25","2620","10536","1520","1100","1979","705000"
"4","2.5","3320","244807","3320","0","2001","675000"
"3","2.5","2220","2873","2010","210","2012","654000"
"4","2","1940","5000","980","960","1910","639000"
"3","2","2360","118483","2360","0","1981","589000"
"3","2.5","1710","1904","1140","570","2003","579000"
"4","2.25","2810","25990","1860","950","1959","571500"
"3","2.75","3160","9072","3160","0","2005","553000"
"2","1","1080","3420","780","300","1922","550000"
"4","2.5","2420","8056","1680","740","1988","550000"
"3","2.5","2680","5860","2680","0","2001","549950"
"3","2.5","2400","12546","2400","0","1983","535000"
"2","1.5","1390","5000","970","420","1954","530000"
"2","2.5","1500","1174","1140","360","2014","529950"
"3","3.25","1460","1254","1460","0","2000","521000"
"3","2","1410","5000","740","670","1908","517950"
"4","2.5","2440","10423","2440","0","1955","510000"
"3","2.5","1995","1483","1760","235","2005","505000"
"3","1.75","1680","2552","840","840","1952","480000"
"3","1.75","2040","273556","2040","0","1997","467500"
"4","2.5","2350","3760","2350","0","2014","459995"
"2","2.5","1350","944","870","480","2004","439000"
"3","2.5","1940","10800","1340","600","1979","432500"
"3","2.5","1860","11122","1860","0","1994","429000"
"4","1","1750","9600","1750","0","1954","420000"
"5","3","2270","6664","1340","930","1995","417500"
"3","1.5","1470","6867","1470","0","1955","401000"
"4","3","1810","5012","1810","0","1997","400000"
"3","2.25","1350","980","1050","300","2007","397500"
"5","1.75","2100","9599","1060","1040","1961","395000"
"2","1.5","1870","12960","1350","520","1926","390000"
"2","1.5","1140","7620","1140","0","1925","379900"
"3","2","1370","7200","1130","240","1926","377500"
"4","2.25","2070","8893","2070","0","1986","365000"
"4","2.5","2300","219106","1840","460","1958","352500"
"3","1.75","1320","10500","1320","0","1966","350000"
"3","1","1080","5250","1080","0","1947","329500"
"3","2.25","2480","8755","2480","0","1979","325000"
"3","1","1040","7288","1040","0","1959","324950"
"4","2.5","2300","3825","2300","0","2012","320000"
"2","1","720","5750","720","0","1943","310000"
"5","2.75","2000","9276","2000","0","1968","300000"
"4","2.5","2230","4952","2230","0","2011","297000"
"4","2.5","2350","8906","2350","0","1993","295000"
"4","2","1710","8814","1030","680","1975","295000"
"4","1.75","2120","9706","1370","750","1965","293550"
"2","1","1020","6380","1020","0","1930","290000"
"3","1.5","1460","8505","1460","0","1955","265000"
"3","2.25","1900","7250","1250","650","1967","245000"
"3","1.5","2100","10000","2100","0","1954","245000"
"2","1","1150","15000","1060","90","1930","224000"
"3","2","1290","9312","1290","0","1947","215000"
"4","2.5","2100","19680","2100","0","1914","207000"
"3","1","1090","17630","1090","0","1962","197000"
"3","2","1320","7625","1320","0","1987","190000"
"5","5","5450","20412","5450","0","2014","3420000"
"8","6","4340","9415","4340","0","1967","2150000"
"3","2.75","3940","9671","2140","1800","1967","1450000"
"4","4.75","5310","57346","5310","0","1989","1370000"
"3","2.5","2860","4500","1980","880","1915","1230000"
"5","5","3960","94089","3960","0","1998","1180000"
"3","2.5","2920","8113","2920","0","1950","1090000"
"5","3.5","5050","16500","5050","0","2001","1030000"
"4","2.5","3480","13421","3480","0","1995","878000"
"4","4.5","4040","8400","3220","820","2006","860000"
"7","6.75","7480","41664","5080","2400","1953","800000"
"4","2.75","2990","4298","2990","0","2014","779950"
"4","2.75","2390","9300","1430","960","1979","770126"
"2","2","2180","21392","2180","0","1934","750000"
"4","1.75","2360","11300","2360","0","1974","732000"
"4","2.5","2540","9870","2540","0","2009","717000"
"5","2","2280","5400","1340","940","1947","712500"
"2","1","1620","9855","1320","300","1948","700000"
"3","1.75","2070","6000","1340","730","1955","690000"
"6","4.5","3900","9100","2870","1030","1979","650000"
"4","2.25","1900","11171","1280","620","1984","629000"
"3","1.75","1970","8540","1130","840","1950","606000"
"4","1.5","2430","4995","1730","700","1928","580000"
"3","3.5","1420","1217","1180","240","2003","579950"
"4","2.75","2180","5799","2180","0","1993","571500"
"4","2.5","2830","10954","2830","0","2003","569000"
"2","1.75","1740","4736","1040","700","1907","565000"
"4","2","1710","3875","1710","0","1907","565000"
"2","2","1930","5520","1930","0","2006","559000"
"4","1.5","3050","82764","1650","1400","1966","555000"
"5","2.75","3000","9473","1500","1500","1966","550000"
"3","2.5","2140","40173","2140","0","1990","545000"
"5","1.5","1940","10202","1940","0","1940","540000"
"4","2.75","2910","9000","2130","780","1966","539950"
"5","2.25","2530","8250","2530","0","1961","527500"
"2","1","1450","4500","1450","0","1921","526000"
"4","2.5","2403","6172","2403","0","1999","519900"
"4","2.5","2830","13760","2830","0","1993","518000"
"4","4","3530","10935","3530","0","1992","510000"
"4","3","2280","7400","1340","940","1978","505000"
"2","1","1570","4704","1570","0","1931","502000"
"3","1.5","960","4600","960","0","1944","500000"
"3","2","2005","7000","1605","400","1980","491000"
"4","2","1830","9610","1830","0","1963","488250"
"3","1","1130","5758","960","170","1939","485000"
"3","2.5","2280","3710","1550","730","1990","475000"
"4","2.5","3202","4964","3202","0","2014","460940"
"3","1.75","2560","8400","1970","590","1959","460000"
"3","1.5","1160","1031","1160","0","2008","459000"
"3","2.25","1540","1270","1540","0","2014","449950"
"4","1.75","2560","8270","1480","1080","1979","448000"
"3","1.75","2350","7641","1510","840","1978","440000"
"3","2.5","1680","2801","1680","0","2011","439000"
"3","1.75","1660","8301","1660","0","1955","434000"
"3","1.75","1610","7900","1310","300","1960","430000"
"4","2","1330","9188","1330","0","1928","425000"
"3","2.5","1860","15457","1860","0","1997","410000"
"3","1.75","1370","9680","1370","0","1977","400000"
"3","2.5","1450","8064","1450","0","1984","400000"
"5","2.25","2070","10488","1080","990","1958","400000"
"3","2.5","1800","3300","1690","110","2004","399000"
"2","1","740","4275","740","0","1924","392800"
"3","2","1930","12443","1930","0","1969","390000"
"5","1.5","1750","9780","1750","0","1961","385000"
"3","2.5","1470","3999","1470","0","2003","381000"
"4","3","2420","9566","2420","0","2003","375000"
"5","2.25","3260","7969","3260","0","1982","353950"
"3","1.75","1560","5760","780","780","1927","353900"
"3","1.75","1730","11986","1730","0","1918","340000"
"2","1.75","1060","1202","760","300","2003","335000"
"3","3","1370","1001","1370","0","2009","327000"
"2","1","1150","9186","1150","0","1946","324950"
"2","1","1030","8576","1030","0","1952","315000"
"2","2.25","1240","705","1150","90","2009","315000"
"4","2.5","2230","6487","2230","0","2003","305000"
"3","1","1520","8320","1520","0","1953","299000"
"3","1","1340","18000","1340","0","1924","297000"
"3","2.5","1660","4898","1660","0","2011","295000"
"3","1.75","2060","7251","1350","710","1987","290000"
"3","1.5","1230","7500","1230","0","1962","270000"
"2","1","760","4000","760","0","1950","265000"
"4","2.5","1960","5238","1960","0","2003","260000"
"2","1","770","6542","770","0","1948","259950"
"3","1.75","2090","7461","1200","890","1986","258000"
"3","1.75","1410","9315","1410","0","1960","255000"
"3","2.5","2020","6564","1310","710","1994","253000"
"3","1","930","6060","930","0","1973","250000"
"3","1","1470","7350","1470","0","1969","240000"
"4","1.75","2020","10332","1010","1010","1954","240000"
"3","1.5","1810","14400","1810","0","1954","229500"
"1","1","550","16345","550","0","1945","188000"
"3","3.5","3760","5634","2830","930","2014","2230000"
"2","2.5","2310","3313","2310","0","2006","1250000"
"5","3.5","3900","4400","2650","1250","2014","1200000"
"3","2.25","2160","7500","2160","0","1982","1010000"
"3","2.25","2300","15952","1150","1150","1963","1000000"
"3","3.5","3840","53696","3840","0","1996","970000"
"3","3.5","2450","9248","1960","490","1933","939000"
"4","1.5","2890","9000","2090","800","1939","910000"
"4","2.25","4470","86225","4470","0","1991","885000"
"3","2.25","3440","10628","3440","0","1985","855000"
"3","1.75","1400","9900","1400","0","1951","850000"
"4","2.5","2910","9000","2910","0","1989","805000"
"4","2.5","3500","7519","3500","0","2004","790000"
"4","3.25","3240","4852","3240","0","2010","789500"
"4","3","3370","100681","1920","1450","1977","785000"
"3","2.5","2700","8444","2700","0","1992","765000"
"4","2.5","2960","28005","2960","0","1989","760000"
"3","2.25","2410","9668","1540","870","1965","715500"
"4","2.25","2450","11960","2450","0","1979","712000"
"3","1.75","2500","36947","2500","0","1984","662000"
"4","2.5","2570","4412","2570","0","2001","655000"
"3","1","1790","5250","1400","390","1943","603000"
"2","3.25","1840","1500","1840","0","2001","601450"
"3","2.5","1790","3962","1790","0","1992","584000"
"3","1.75","2140","13286","1220","920","1964","577500"
"2","1.75","2070","23160","1260","810","1946","577000"
"4","2.5","3230","7187","3230","0","2008","570000"
"3","2.25","1990","8501","1990","0","1991","564800"
"3","1","1140","7028","1140","0","1931","560000"
"3","3.5","1560","2198","1180","380","2006","560000"
"3","3.5","3350","5500","2670","680","2014","557500"
"4","2.5","2329","9436","2329","0","1995","540000"
"3","2","1870","5455","1060","810","1926","521000"
"4","2.25","2470","7800","1470","1000","1975","515000"
"3","2","1560","1020","1560","0","2014","515000"
"4","2.25","2490","23478","2490","0","1981","500000"
"3","2.25","2880","7200","1710","1170","1970","499950"
"5","1.5","2170","11250","1230","940","1959","497500"
"2","2.5","1170","809","1170","0","2007","482500"
"3","2.5","1710","8998","1710","0","1982","479000"
"3","1.5","1640","2720","1640","0","1929","475000"
"3","1","910","3880","780","130","1942","465000"
"3","2.25","1870","7403","1870","0","1950","455000"
"4","1.75","1640","1480","820","820","1912","450000"
"4","2.5","2430","3249","2430","0","2010","427500"
"3","2.5","1770","3993","1770","0","1999","420000"
"3","1","1310","4163","1310","0","1964","415885"
"3","1","1510","6083","860","650","1940","415000"
"3","2","2050","9396","1170","880","1960","399950"
"3","1","1720","8910","1720","0","1954","399950"
"4","1.75","1960","7945","980","980","1946","395000"
"3","1","1380","6591","1380","0","1947","389000"
"2","1","770","7554","770","0","1946","385000"
"3","2.5","1650","2082","1650","0","2007","378000"
"5","3","2680","8410","1810","870","1990","375000"
"4","2","2500","36900","1540","960","1972","368000"
"4","1.5","1820","12327","1380","440","1955","365000"
"3","2","1970","79714","1070","900","1979","360000"
"2","2.5","1770","4950","1770","0","2003","350500"
"3","2.5","1420","1162","1420","0","2002","349950"
"5","3.5","2660","6978","1980","680","1996","332100"
"2","1","880","1753","880","0","1945","330000"
"3","1.5","1370","11400","1370","0","1980","280000"
"2","1","890","8180","890","0","1947","275400"
"4","2.5","2701","5821","2701","0","2013","270000"
"3","2.5","1850","6676","1850","0","1986","268000"
"3","1.75","1360","16000","1360","0","1978","250000"
"3","1.5","1420","8580","1420","0","1962","224097"
"3","1","1980","18730","1280","700","1943","207000"
"3","1","980","9682","980","0","1969","201000"
"3","1.75","1420","7205","1420","0","1986","192500"
"2","1","800","5600","800","0","1955","189900"
"3","2.25","1740","6650","1240","500","1978","182700"
"4","1.5","1450","5530","1450","0","1969","175409"
"3","1.75","1370","8006","1370","0","1990","160000"
"4","4.5","4300","19844","4300","0","1985","2500000"
"4","4.5","6380","88714","6380","0","2006","1820000"
"3","2.5","4010","12105","2600","1410","1983","1510000"
"4","3.25","3600","38016","3310","290","1991","1420000"
"5","3.25","4300","9270","2910","1390","1957","1400000"
"3","2","2310","21318","2310","0","1979","1360000"
"4","2.25","2240","11034","2240","0","1976","980000"
"3","3.25","2080","3025","1220","860","1984","969500"
"4","3","3230","438213","3230","0","1999","950000"
"5","1","2590","4652","2310","280","1907","890000"
"3","3","1910","4800","1910","0","1900","850000"
"5","3.5","3600","9312","2680","920","2005","817500"
"4","2.75","3170","7634","3170","0","1992","750000"
"3","1.5","1790","6000","1790","0","1903","725000"
"5","2.75","3630","38461","3630","0","2000","716500"
"4","3.5","3190","6875","2120","1070","1999","675000"
"4","1.75","2640","8215","1500","1140","1966","650000"
"4","2","1690","35346","1690","0","1967","612500"
"3","3","1800","5000","1500","300","1929","606400"
"6","1.75","2180","4000","1380","800","1926","580000"
"5","2.75","3080","5752","3080","0","2014","579950"
"3","1.75","1720","5956","1720","0","1981","575000"
"4","2.5","2280","9725","2280","0","1986","565000"
"3","1.5","2790","6900","1700","1090","1955","560000"
"3","2.5","2130","7199","2130","0","1990","546500"
"3","2.25","1270","2790","990","280","1970","543500"
"3","2.5","2810","4607","2810","0","2004","533000"
"4","1.75","1760","3600","880","880","1926","527950"
"3","1.75","1970","8000","1970","0","1968","525000"
"3","3","1845","5100","1845","0","1947","510000"
"3","2","1990","7405","1990","0","1971","510000"
"2","1.75","1670","6460","1670","0","2004","507000"
"3","2.25","1730","13040","1290","440","1988","500000"
"5","2.5","2340","7200","1300","1040","1975","475000"
"4","2.75","2790","6600","2790","0","2000","459000"
"5","3.5","3080","7759","2310","770","2003","455000"
"3","2.5","2240","7791","2240","0","2002","452500"
"4","2","2430","199940","1310","1120","1961","449500"
"4","1","1480","7560","1480","0","1940","440000"
"4","2.25","2240","8300","2240","0","1978","439000"
"3","2.5","1820","7500","1820","0","1985","424000"
"3","1","1580","13912","1580","0","1955","424000"
"3","2.5","1960","6997","1960","0","2006","405000"
"2","1","710","5100","710","0","1905","402000"
"3","2","3000","17800","1500","1500","1962","400000"
"4","2.5","3140","12792","3140","0","1977","400000"
"3","1","1000","7800","860","140","1930","400000"
"4","2","1757","19370","1757","0","1955","375000"
"3","2.25","1980","7200","1300","680","1964","355000"
"2","1","1450","6380","1450","0","1967","350500"
"4","1.75","1780","5000","890","890","1903","349950"
"3","2.25","1640","7261","1640","0","1989","349000"
"3","1.5","1590","7260","1080","510","1964","339275"
"4","1.75","2000","10890","1390","610","1961","335000"
"5","3","2020","5917","1220","800","1993","311000"
"1","1","730","5005","730","0","1945","306950"
"4","2.5","1910","8058","1910","0","1992","300000"
"2","0.75","440","8313","440","0","1943","290000"
"3","1","1480","32700","1380","100","1942","290000"
"4","2.5","2240","4648","2240","0","2005","287000"
"2","1","930","6900","930","0","1952","287000"
"3","1.75","1930","7267","1330","600","1977","279950"
"2","1","870","2676","820","50","2004","276000"
"3","1.75","1440","10920","1440","0","1977","267000"
"3","1.75","1470","10390","1470","0","1989","262500"
"3","1","1690","13825","1210","480","1955","257500"
"2","1","920","43560","920","0","1923","255000"
"3","1","1030","5000","1030","0","1960","253000"
"4","1","1330","7980","1330","0","1952","249950"
"3","2.5","1460","11593","1460","0","1989","245000"
"3","1.5","1450","9477","1450","0","1963","240000"
"2","1","720","6345","720","0","1943","240000"
"4","1.5","2070","7245","1060","1010","1964","235000"
"2","1","930","6600","930","0","1957","226950"
"3","1","810","5240","810","0","1942","215000"
"4","1.75","1850","65340","1850","0","1972","205000"
"2","2.5","1240","3649","1240","0","1986","153503"
"2","1","1060","16988","1060","0","1954","151600"
"3","1","910","11117","910","0","1955","128000"
"4","3.25","4890","13402","4890","0","2004","1780000"
"3","2.5","2560","3600","2110","450","1967","1400000"
"5","1.75","2130","19180","1500","630","1968","1300000"
"3","3.5","3220","3960","2760","460","1991","1260000"
"3","2.5","2830","56628","2830","0","2001","1080000"
"4","3.25","5010","49222","3710","1300","1978","965000"
"5","2.5","3490","18850","1840","1650","1958","915000"
"4","2.5","2650","12001","2650","0","1984","870000"
"3","1.75","2600","15064","1700","900","1967","860000"
"5","3.75","3760","4702","2780","980","2014","799950"
"3","2","2550","4794","2550","0","2007","799000"
"4","2.25","3200","53357","3200","0","1972","785000"
"3","1.5","1620","7500","1620","0","1949","780000"
"2","1","1010","3600","1010","0","1913","775000"
"3","2.25","2420","23507","2420","0","1969","774888"
"5","2.75","2540","8250","1440","1100","1953","760250"
"5","1.75","2660","10637","1670","990","1922","760000"
"4","2.25","3040","9690","1940","1100","1978","760000"
"5","3.75","3360","6000","2640","720","1963","725000"
"4","2.75","2780","6978","2780","0","2001","710000"
"2","1","1160","17635","1160","0","1945","700000"
"4","2.75","2450","5376","1550","900","1920","696950"
"3","2.25","2090","45535","1280","810","1952","693000"
"5","3.25","3370","7313","2140","1230","1988","690000"
"3","2.75","2480","3240","1890","590","1929","690000"
"5","2.5","3160","5635","3160","0","2003","685000"
"3","2.25","2840","59677","1580","1260","1967","663000"
"3","2.5","1950","7481","1950","0","1987","622000"
"3","2.5","1880","5500","1880","0","1947","617000"
"4","2.25","2500","10062","1600","900","1975","615000"
"3","1","1000","4959","1000","0","1945","610000"
"3","1.75","1650","221720","1650","0","1992","610000"
"3","1.5","2240","3750","1220","1020","1952","608000"
"4","1.5","1880","3500","1080","800","1926","605000"
"4","2","2490","339332","2490","0","2002","590000"
"3","2.75","1710","3600","1590","120","1909","575000"
"3","1.75","1580","3764","1280","300","1945","536000"
"4","1.75","1820","6600","1820","0","1960","525000"
"3","2.25","2380","6250","2040","340","1961","490000"
"3","2.5","3080","7363","3080","0","2006","490000"
"3","1.75","2480","10804","1800","680","1976","489950"
"4","3.5","3660","14401","2660","1000","1994","475000"
"4","3","2410","8284","1210","1200","1969","475000"
"2","1.75","1320","3420","1080","240","1955","475000"
"3","1","1140","4560","770","370","1944","474000"
"4","1","1740","37238","1740","0","1932","470000"
"5","2.5","2310","8303","1300","1010","1975","469950"
"3","1.75","1270","7700","1270","0","1968","455000"
"3","2.5","1730","4408","1730","0","1996","445000"
"3","1.5","1310","1266","1120","190","2002","445000"
"3","1.75","1720","15225","1020","700","1970","430000"
"4","2.5","3010","9155","3010","0","2005","419000"
"3","1.75","1660","5987","960","700","1982","410000"
"4","3.25","3140","10752","2300","840","1992","409000"
"1","1","700","5621","700","0","1945","403500"
"2","2","1520","5010","1520","0","1999","400000"
"3","1.75","2030","217800","2030","0","1977","395000"
"3","1.75","2700","18246","1510","1190","1967","381000"
"2","1.75","2510","19141","2510","0","1977","368500"
"4","1.75","2030","7210","1450","580","1968","359500"
"3","1.5","1860","17640","1860","0","1966","350000"
"4","2.5","1970","7098","1970","0","2007","347500"
"3","1","1160","9600","1160","0","1967","330000"
"2","2","970","5000","970","0","1983","325000"
"5","2.25","2630","8625","2630","0","1966","320000"
"3","2.25","1250","1017","1250","0","2008","318000"
"3","1","1250","20040","1250","0","1970","318000"
"3","1","1310","8370","1310","0","1962","311000"
"4","2.5","2300","7500","1650","650","1959","308130"
"4","1.75","2130","11097","1370","760","1952","292000"
"3","1","1050","16050","1050","0","1960","287653"
"3","1","1100","5132","840","260","1948","280000"
"5","2","2110","7919","1110","1000","1966","280000"
"3","1.75","1360","6603","1360","0","1981","280000"
"4","2.25","1800","5555","1800","0","2003","272000"
"3","2.5","1740","3721","1740","0","2009","257000"
"3","1","1250","10094","1250","0","1927","255000"
"3","2.75","1900","16117","1900","0","1958","255000"
"2","1","910","9000","910","0","1923","244500"
"2","1","910","9000","910","0","1983","239900"
"2","1","770","6450","770","0","1948","230000"
"3","1","1080","16000","1080","0","1952","225000"
"3","1.75","1370","8280","1370","0","1980","222000"
"2","1","1050","9000","1050","0","1984","219000"
"2","1","770","7000","770","0","1921","212000"
"2","1","1010","43056","1010","0","1990","155000"
"5","6","5490","19897","5490","0","2005","3640000"
"1","1","1390","60984","1390","0","1960","400000"
"4","2.5","2960","4750","2960","0","2005","785000"
"3","2.5","1630","7586","1630","0","1986","475000"
"4","1.5","1730","7464","1730","0","1959","243400"
"6","8","12050","27600","8570","3480","1910","7700000"
"3","3","4380","6320","3580","800","1952","1450000"
"4","3.5","4360","24603","4360","0","1998","1450000"
"4","3.25","3330","9000","2870","460","2004","1210000"
"2","1.75","2080","8112","1040","1040","1939","1190000"
"4","2.25","2480","6000","2380","100","1929","979700"
"4","2.5","3810","13579","3810","0","2003","920000"
"3","2.25","2560","3996","2150","410","1910","842500"
"4","4","3280","8448","3280","0","2007","785500"
"4","2.5","3180","15358","3180","0","1988","775000"
"4","2.5","3110","6930","3110","0","2004","755000"
"4","3.5","3080","5974","3080","0","2003","733000"
"3","2","1550","12262","1550","0","1964","725000"
"5","2.5","2570","9600","1620","950","1956","710000"
"4","2.5","3280","16575","2190","1090","1972","706000"
"4","2.5","2790","6540","2790","0","1999","695000"
"4","2.5","2580","9450","1660","920","1959","650000"
"2","1","1240","5000","1000","240","1920","645000"
"4","1.75","2060","9828","2060","0","1960","640000"
"3","2.25","2210","22040","1510","700","1976","635250"
"4","2.5","2601","34335","2601","0","1995","625000"
"4","2","1760","5307","1170","590","1948","625000"
"4","2.75","2300","12633","2300","0","1984","623000"
"3","3","1730","1755","1730","0","2014","577450"
"3","1.75","1516","2897","998","518","1925","575575"
"3","2.5","3110","217800","3110","0","2001","559000"
"4","2.5","3118","1845","3118","0","2014","541800"
"5","3","2570","5590","1580","990","2009","540000"
"3","1","1320","5250","1320","0","1913","526000"
"4","2.5","2980","12075","1910","1070","2007","495000"
"3","2","1660","5070","1660","0","1950","491000"
"5","2","1760","21562","1560","200","1959","480000"
"5","3.5","3790","8200","2120","1670","2001","471750"
"2","1","1190","5200","1190","0","1912","470000"
"2","1.5","1710","4189","1160","550","1951","453500"
"3","1","1120","9656","1120","0","1955","435000"
"3","2.5","2210","9226","2210","0","1998","432900"
"5","1.75","2860","12293","1430","1430","1947","411000"
"4","1","1420","4875","1420","0","1930","400000"
"4","2.5","2740","8336","2740","0","1990","395000"
"3","1.75","1600","8156","1600","0","1948","393500"
"4","1.5","1940","12100","1940","0","1962","390000"
"2","1","850","3276","850","0","1910","389000"
"4","1.75","1760","7300","880","880","1956","380000"
"4","2.25","1990","21312","1990","0","1968","365000"
"2","1","930","6098","930","0","1919","360000"
"3","2.25","1650","7218","1230","420","1985","359000"
"3","1.75","1250","17493","1250","0","1972","357000"
"4","2.5","2632","4117","2632","0","2013","349950"
"1","1","540","10125","540","0","1961","345000"
"3","1.5","1390","13860","1390","0","1979","345000"
"2","1","700","4000","700","0","1943","330000"
"2","1","990","15120","990","0","1953","325000"
"4","1","1300","18836","1300","0","1941","321000"
"4","1.75","2320","12000","2270","50","1973","318888"
"1","1","900","7500","900","0","1946","305000"
"3","2.5","1960","1477","1670","290","2012","300000"
"4","2.5","1850","5674","1850","0","1993","290000"
"4","2","1400","7632","1400","0","1930","246000"
"3","2","1410","10625","1410","0","1980","230000"
"3","1","1180","5650","1180","0","1955","221900"
"3","1","960","5700","960","0","1956","208950"
"6","2.5","1560","7144","1060","500","1913","194990"
"4","5.5","7080","16573","5760","1320","2008","4000000"
"3","2.5","2510","12779","2510","0","1968","1950000"
"3","2.25","4320","19225","2160","2160","1972","1780000"
"4","1.75","2410","6000","2410","0","1911","1440000"
"4","3.25","4190","10259","3150","1040","2000","1150000"
"4","3.5","4560","41636","4170","390","1995","1100000"
"4","3.5","3310","4684","2290","1020","2014","999950"
"4","2.75","3340","5700","3340","0","2013","962000"
"3","1.75","2480","4000","1240","1240","1948","920000"
"2","2.25","2470","7658","1480","990","1954","898000"
"4","1.75","2660","3520","2080","580","1917","896000"
"4","3","2550","3784","1750","800","1900","850000"
"5","3.5","4200","5400","3140","1060","2012","850000"
"3","1.75","1870","9897","1870","0","1960","811000"
"3","2.75","3530","69834","3530","0","1994","760000"
"4","1.75","2100","3400","1100","1000","1915","750000"
"4","2","2060","6000","1370","690","1954","705000"
"4","2.75","3880","15025","3880","0","2004","702000"
"3","2.25","3420","9900","1710","1710","1963","692500"
"3","1.5","1280","2114","1280","0","1904","687500"
"4","2.5","2520","5000","2520","0","2004","680000"
"3","3","2330","1944","1950","380","2014","669950"
"3","3.25","1720","936","1030","690","2004","649000"
"4","2.75","3150","7379","2430","720","1915","640000"
"5","3","2800","5700","2800","0","2014","639983"
"4","2","2020","6867","1010","1010","1942","625000"
"4","2.5","2210","5077","1480","730","1912","619500"
"3","3","1740","3700","1740","0","1982","612000"
"4","2.5","2520","6023","2520","0","2014","610685"
"4","2.5","2300","10843","2300","0","1955","610000"
"3","2.75","3230","5250","2680","550","2014","591975"
"4","2.5","2630","15000","2630","0","1962","589000"
"4","3","3220","6224","3220","0","2009","584950"
"3","1.75","1710","5000","1360","350","1918","561000"
"4","1.75","2480","14782","1460","1020","1958","550000"
"3","2.75","2330","4780","1730","600","1930","550000"
"3","2.5","2070","39768","2070","0","1988","542950"
"2","2","1640","3021","840","800","1959","540000"
"3","2.5","2074","4900","2074","0","1997","515100"
"4","3","1820","8261","1420","400","1969","515000"
"2","1.5","1480","3120","930","550","1914","509250"
"4","2.25","3320","53392","2000","1320","1986","508000"
"4","1.75","3220","7392","2010","1210","1959","485000"
"2","1.5","1790","3760","1280","510","1928","460000"
"4","1","1340","5800","1340","0","1914","455000"
"3","2","1320","3827","1320","0","1947","445800"
"3","1.75","1850","7056","1850","0","1979","445000"
"3","2","1920","7598","1920","0","1972","443500"
"2","1.75","1010","4000","1010","0","1919","441500"
"2","2","1300","6515","1300","0","2005","439888"
"3","1","1180","7200","1180","0","1949","425000"
"3","2.5","2370","15375","2370","0","1993","420000"
"3","1","1310","3963","1310","0","1986","420000"
"5","2.75","2710","4500","2710","0","2014","419354"
"3","1.75","1270","10790","1270","0","1956","403000"
"4","2.5","2350","3904","2350","0","1999","400000"
"2","1.5","1180","1722","1180","0","2006","399500"
"3","1","860","6380","860","0","1927","397000"
"3","2.25","2270","32112","1740","530","1980","390000"
"3","1.75","1580","9049","1580","0","1966","389950"
"3","3.25","1860","2218","1860","0","2001","387500"
"3","1.75","1350","155073","1350","0","1969","385000"
"3","1.75","1160","8774","1160","0","1972","370000"
"4","2.5","2350","8182","2350","0","1997","367000"
"3","1","1160","10988","1160","0","1965","360000"
"3","2","1480","2502","1480","0","1991","355000"
"4","2.5","2390","6976","2390","0","2003","345000"
"2","1","750","6439","750","0","1934","338000"
"2","2.5","980","1021","980","0","2008","329900"
"4","2.5","2963","5797","2963","0","2006","325000"
"3","2.25","1840","7326","1370","470","1979","319990"
"4","2.75","2500","5100","1420","1080","1907","319500"
"4","1.75","1630","3000","930","700","1978","313000"
"4","2.5","1914","3272","1914","0","2009","300000"
"3","2.5","1690","4988","1690","0","2002","297000"
"3","1.75","1630","4000","1100","530","1968","285000"
"3","2.25","1360","9600","1360","0","1992","280000"
"4","2.5","2290","3777","2290","0","2004","278000"
"2","1.5","830","1325","830","0","2005","271115"
"3","1","1010","14948","1010","0","1969","265000"
"3","2","1130","7200","1130","0","1944","262500"
"3","2.5","1510","6095","1510","0","1991","260000"
"2","1","700","5000","700","0","1943","225000"
"3","2.25","1650","7739","1290","360","1986","225000"
"4","1.75","1400","25500","1400","0","1964","218500"
"3","1","1070","7615","1070","0","1969","195000"
"3","1","1010","11880","1010","0","1960","145000"
"3","1","920","7276","920","0","1961","125000"
"3","1","900","4750","900","0","1969","89000"
"5","4.5","6200","23373","5050","1150","1988","1960000"
"5","3.25","5570","9600","3860","1710","1952","1860000"
"4","2.75","3520","19200","1950","1570","1951","1660000"
"4","3.25","4240","11189","4240","0","2006","1660000"
"5","3.75","4470","8088","4470","0","2008","1540000"
"4","2.5","2770","7800","2770","0","1999","1200000"
"2","2.25","2320","9300","1920","400","1937","1150000"
"4","3.5","3660","4760","2840","820","2014","1110000"
"3","2.25","2890","21480","1790","1100","1941","1070000"
"4","3.25","3830","8331","3830","0","2014","1050000"
"3","2.5","3680","13384","3680","0","1994","1030000"
"4","2.25","2430","10050","2430","0","1979","825000"
"3","3.75","2780","5002","2780","0","1999","815000"
"4","2.75","2890","16397","2890","0","1997","795000"
"4","2.75","2660","4500","1860","800","1909","765000"
"4","1.75","2770","8521","1470","1300","1953","760000"
"4","2.75","3980","285318","3980","0","2006","760000"
"4","2.5","3020","13122","2540","480","1997","750000"
"4","2.5","3400","4840","3190","210","2006","745000"
"3","3.25","4460","51177","4460","0","2005","739500"
"4","2.75","2920","4500","2920","0","1999","730000"
"7","2.75","3110","4400","2010","1100","1914","730000"
"4","2.5","3130","7582","3130","0","2004","665000"
"2","1","2160","2192","1170","990","1925","625000"
"3","3.5","1690","1765","1370","320","2006","622000"
"4","2.5","2980","210395","2980","0","2001","620000"
"4","2.5","2440","9350","1560","880","1976","610000"
"5","3.25","4410","58157","2330","2080","2001","600000"
"5","3","3110","4464","3110","0","2007","588000"
"5","2.5","2620","8050","1520","1100","1975","550120"
"4","2.5","2360","15008","1920","440","1986","535000"
"4","1.75","2540","7200","1270","1270","1947","525000"
"4","1.75","1480","7875","740","740","1927","511200"
"4","2.75","2980","9825","1910","1070","2007","505000"
"2","2.5","1430","1201","1430","0","2009","505000"
"3","1.75","1220","7370","1220","0","1964","500000"
"2","1.75","2220","33000","2220","0","1970","494950"
"4","2","1690","8208","1210","480","1958","478000"
"4","2.5","2780","7290","2780","0","1989","478000"
"3","3","1380","1081","1380","0","2005","473000"
"4","1.75","1920","7986","960","960","1952","440000"
"4","1","1710","7000","1710","0","1950","433000"
"2","2","1440","6677","870","570","1952","425000"
"4","2.5","2170","10500","1570","600","1962","420000"
"3","2.5","1570","1551","1570","0","2008","414950"
"3","1.5","1420","7520","1420","0","1956","413107"
"4","1.75","2580","19607","1290","1290","1958","383000"
"4","1.75","2420","8400","1620","800","1964","350000"
"4","2.75","2530","13474","2530","0","1994","349900"
"6","5","2732","7655","2732","0","2009","343000"
"3","2","1690","9087","1690","0","1997","337000"
"4","2.5","1900","3301","1900","0","2007","335000"
"4","2","2750","9001","2750","0","2008","333000"
"4","2.5","2380","5737","2380","0","2010","332000"
"3","1.75","1320","9675","1320","0","1970","330000"
"2","2.25","1260","1032","1170","90","2008","329950"
"2","2.5","980","1020","980","0","2008","329000"
"4","2.5","1850","7324","1850","0","1997","325000"
"2","0.75","1020","1076","1020","0","2008","325000"
"3","3.25","1510","1245","1510","0","2007","319950"
"3","1.75","1130","7500","1130","0","1908","315450"
"1","1","580","7200","580","0","2000","315000"
"4","2.5","2310","7384","2310","0","2010","310000"
"2","1","1030","6000","1030","0","1925","305000"
"3","1.75","1700","8481","1700","0","1993","300000"
"3","2.5","1852","4000","1852","0","2014","298900"
"3","1.5","1280","16738","1280","0","1932","279000"
"3","1","1500","9253","890","610","1945","273000"
"3","2.5","1660","5550","1660","0","2002","270000"
"3","2.5","1920","4803","1920","0","2005","266950"
"3","1.5","1120","8250","1120","0","1957","266000"
"3","1","1780","7800","1060","720","1957","261000"
"4","2.5","2150","3721","2150","0","2006","260000"
"2","1","890","6380","890","0","1951","250000"
"4","1.75","1860","7350","1090","770","1977","250000"
"4","1.75","1630","8410","1630","0","1943","249000"
"3","1.75","1260","8614","1260","0","1985","245000"
"3","1","1350","7560","950","400","1959","240000"
"2","1","1270","9182","1270","0","1917","235000"
"4","3","2160","5000","1320","840","1978","228950"
"2","1","780","6727","780","0","1939","221900"
"3","3.5","1540","1427","1360","180","2007","216650"
"3","3.5","1480","1077","1300","180","2007","216650"
"3","1","1180","6050","820","360","1944","194000"
"2","1","860","5400","860","0","1953","187000"
"3","2.5","1800","8518","1800","0","1996","180500"
"4","2.75","4280","12668","3900","380","1947","1900000"
"4","3.5","3440","3800","3440","0","2014","1290000"
"4","3.5","3830","7150","3830","0","2014","989990"
"5","3","2710","8227","1910","800","1953","951250"
"3","2.25","2890","5000","2890","0","2014","930000"
"3","1.75","3670","11884","1950","1720","1979","920000"
"3","1","1560","8232","1560","0","1952","915000"
"8","4","4020","7500","2010","2010","1968","900000"
"4","3.25","3400","99170","2000","1400","1980","865000"
"3","3.5","2620","11148","2060","560","1977","850000"
"4","1","2150","3588","1850","300","1926","810000"
"3","2","2610","6000","1310","1300","1941","780000"
"5","2.5","1660","4000","1660","0","1929","780000"
"6","4.25","4310","10000","2950","1360","2008","780000"
"4","1.5","2740","175421","1370","1370","1937","779000"
"4","2.5","3170","9900","3170","0","1979","777000"
"4","1.75","1890","4800","1390","500","1906","775000"
"4","2","2040","11850","1020","1020","1959","749000"
"3","1.5","1940","4000","1310","630","1915","728000"
"4","3","2750","7500","1630","1120","1966","710000"
"3","1.5","2240","7227","1440","800","1977","700000"
"4","2.5","2830","8399","2830","0","1998","680000"
"3","1","1180","4166","1180","0","1926","630500"
"4","2.25","1920","8259","1920","0","1979","625000"
"4","2.25","2470","7350","1600","870","1978","618000"
"4","2","2130","2620","1650","480","1919","610000"
"4","2.5","2240","9385","2240","0","1991","590000"
"3","1","1440","3060","1440","0","1910","567500"
"5","1.75","2040","8996","1020","1020","1962","561750"
"4","2.5","2230","7200","1220","1010","1957","556000"
"5","2.75","2160","5720","1500","660","1950","550000"
"4","1.75","2410","8447","2060","350","1936","550000"
"5","2.75","2620","6389","2620","0","2007","535000"
"3","2.25","2160","8114","1460","700","1960","530000"
"3","2.75","2440","45738","1840","600","1987","530000"
"3","1","1520","1210","1520","0","1956","522500"
"2","1.5","1760","12000","1760","0","1964","500000"
"3","2","1460","9759","1460","0","1972","495000"
"4","1.75","2040","3570","1020","1020","1917","495000"
"4","2","1910","2874","1060","850","1910","493000"
"4","3","3110","18843","3110","0","1995","485000"
"3","2.25","1830","39165","1830","0","1963","470000"
"2","1","780","2750","780","0","1928","464050"
"3","3.25","1370","1194","1370","0","2005","460000"
"4","1.75","2260","9703","1660","600","1978","459000"
"2","1.75","1160","6828","860","300","1941","458500"
"3","1","1360","3737","1360","0","1910","450000"
"3","1","1180","4219","1060","120","1939","435000"
"2","2.25","1180","1253","840","340","2008","419000"
"4","3.5","2380","5809","1750","630","1995","413000"
"2","1.5","1430","8137","1130","300","1934","403250"
"4","2.5","2650","4120","2650","0","2014","398651"
"4","2","1530","5250","1110","420","1981","381800"
"3","1","1200","5404","1200","0","1937","375000"
"3","2.5","2490","18525","2490","0","1995","370000"
"3","1.5","2110","5195","1210","900","1959","369000"
"4","1.75","2180","9702","1090","1090","1962","363500"
"4","2.75","2260","5705","2260","0","2014","359950"
"5","2.5","2344","8000","1560","784","1976","355000"
"4","1","1440","7215","1440","0","1969","355000"
"3","1.75","710","5050","710","0","1950","345000"
"2","1","1160","8504","1160","0","1949","345000"
"2","1","1230","7560","1230","0","1961","343000"
"3","1.75","2140","13260","1240","900","1948","340000"
"1","0.75","770","4600","770","0","1910","315000"
"2","1","1000","7228","1000","0","1947","311300"
"1","1","670","4920","670","0","1920","310000"
"1","1.5","1120","912","1120","0","2011","310000"
"2","1.5","800","2142","800","0","2006","305000"
"2","1.75","1120","758","1120","0","2012","305000"
"5","1.5","2040","11772","1030","1010","1963","287000"
"3","1.5","1780","12231","1780","0","1956","285000"
"4","2.5","2434","4400","2434","0","2007","285000"
"4","2","1960","30480","1060","900","1972","275000"
"3","1.5","1170","1174","840","330","2007","275000"
"4","2.25","2040","7600","1580","460","1978","272000"
"3","2.25","2100","14027","2100","0","1979","270000"
"3","2.25","1584","2800","1584","0","2012","261000"
"3","2.5","1610","3517","1610","0","2005","249900"
"3","2.25","1440","10500","1130","310","1983","246000"
"3","2.5","2170","9900","1690","480","1980","242050"
"4","1.75","1420","5382","1040","380","1942","240000"
"3","2","1100","6360","1100","0","1991","240000"
"5","2.25","2240","9652","2240","0","1990","238000"
"3","1","1270","5000","1270","0","1949","235000"
"2","1.75","910","2693","910","0","2003","200000"
"4","2","1440","9477","1440","0","1943","199000"
"2","1","950","15996","950","0","1946","193500"
"3","3","1530","9997","1020","510","1992","154000"
"2","1","840","12750","840","0","1925","150000"
"4","3.5","4010","9654","4010","0","2007","1740000"
"2","2.25","2950","15593","1560","1390","1942","1550000"
"4","3.5","4200","14353","3640","560","1996","1460000"
"4","2.75","3590","5625","3590","0","2012","1100000"
"4","2.5","4200","35267","4200","0","1990","1080000"
"4","3.5","4320","8490","3280","1040","2005","1040000"
"3","1","1620","4774","1620","0","1920","842000"
"2","1","1240","42247","1240","0","1915","825000"
"3","2.5","2980","18935","2980","0","1990","820000"
"4","2.25","2010","7200","1010","1000","1950","800000"
"4","1.75","1500","6820","1500","0","1905","782000"
"4","3.5","3720","213073","3720","0","2007","780000"
"2","2.5","2680","7625","2680","0","2002","779950"
"4","4","3180","7650","2530","650","1920","775000"
"5","2.5","2870","4712","2870","0","2014","760369"
"3","1","1390","9112","1390","0","1951","745000"
"4","1.75","2380","5700","1820","560","1946","735000"
"3","2.5","1800","4400","1350","450","1970","680000"
"6","2","2840","228690","2720","120","1948","640000"
"3","2.5","2080","167270","2080","0","2000","610000"
"4","2.5","2310","3866","2310","0","2005","600000"
"4","2.5","2090","7290","1420","670","1966","600000"
"3","2.5","2610","7301","2610","0","2004","575000"
"2","1","1100","6240","1100","0","1941","570000"
"4","2.5","2280","4534","2280","0","2003","570000"
"4","1.75","2100","6480","1300","800","1947","522500"
"3","2","1290","5700","1290","0","1950","521450"
"4","3","3590","8249","3590","0","1997","515000"
"3","1.75","1530","8829","1530","0","1972","500000"
"2","1","1120","3220","1120","0","1923","500000"
"2","1","1100","3500","1100","0","1908","474000"
"3","2.5","1190","1290","1190","0","2008","469000"
"5","2.25","2500","13500","1850","650","1979","467000"
"3","2.25","1920","990","1240","680","1961","465000"
"3","1.75","3150","9258","2370","780","1970","450000"
"3","2.25","1570","3827","1570","0","1991","447450"
"4","2","2410","8712","1260","1150","1958","446800"
"3","2.5","1690","3129","1690","0","2002","442500"
"3","2.5","2440","71002","2440","0","1996","431000"
"3","2","2000","10490","1430","570","1978","423500"
"3","2.5","1360","3188","1360","0","1986","419500"
"3","1.75","1500","19113","1500","0","1984","418000"
"3","1.75","1900","10454","1390","510","1978","405000"
"4","1","2320","4000","1310","1010","1921","400000"
"3","2.5","2310","4930","2310","0","1989","395000"
"4","2","1780","8149","1780","0","1948","395000"
"3","1","1040","8075","1040","0","1961","390000"
"3","1","1000","4171","1000","0","1985","352500"
"4","2.75","2500","5995","2500","0","2008","350000"
"4","2.5","2040","5875","2040","0","2004","345000"
"3","2","1420","16000","1420","0","1966","324450"
"4","2.5","1970","4558","1970","0","2005","320000"
"3","2","1770","9685","1770","0","1948","315000"
"4","2.5","3140","22100","1820","1320","1960","310000"
"4","1.75","1275","20000","1275","0","1991","309600"
"3","2.5","1990","3614","1990","0","2005","309000"
"4","2","2610","14321","1690","920","1940","294950"
"4","2","1710","5440","1030","680","1976","280000"
"3","2.25","1380","7226","1140","240","1987","265000"
"3","2.5","1340","10290","1140","200","1981","265000"
"5","2.75","2930","10148","2930","0","2002","257000"
"3","1.75","1820","8740","1820","0","1987","247000"
"2","2","1070","4500","910","160","1932","245000"
"2","1","800","5000","800","0","1944","225000"
"3","1.75","1360","10573","1360","0","1984","223000"
"3","2","1260","4125","1260","0","1998","216000"
"3","1.5","1280","5065","1280","0","1983","215000"
"3","2","1760","9282","1100","660","1947","215000"
"3","1","1700","11390","1700","0","1967","210000"
"3","1","1120","8576","1120","0","1943","202500"
"2","2.5","1370","3438","1370","0","1987","190000"
"3","1","1260","10900","1260","0","1943","190000"
"2","1","960","5508","770","190","1951","175000"
"2","1","730","5200","730","0","1928","114000"
"5","3.25","3680","6060","2630","1050","1925","1850000"
"3","2.5","2240","41339","2240","0","1945","1010000"
"4","3.5","2980","2147","2490","490","2006","690000"
"5","2.75","2500","7140","1250","1250","1968","530000"
"5","3.25","3620","4650","2790","830","2004","394000"
"3","2","1450","9333","1450","0","1972","245000"
"3","1.75","2930","266587","2440","490","1995","549950"
"5","3.5","2730","42500","1530","1200","1989","542500"
"3","2","1470","1656","1310","160","2003","380000"
"3","1.75","2130","5489","1370","760","1999","338500"
"5","5.25","8010","45517","5990","2020","1999","5110000"
"8","4","7710","11750","6090","1620","1904","3300000"
"4","2.5","3560","15450","2060","1500","1977","1280000"
"5","3.5","3090","3600","2060","1030","2000","1110000"
"5","4.5","2120","8944","2120","0","1939","1000000"
"5","3.25","3830","6507","3830","0","2014","955990"
"3","3","3420","7826","2430","990","1939","908800"
"4","2","1190","8190","1190","0","1945","900000"
"4","3","4370","217882","4370","0","1984","897500"
"4","2.5","2820","6120","2820","0","2014","897000"
"3","2","1540","3600","1540","0","1900","850000"
"4","2.5","3430","7508","3430","0","1998","813000"
"3","1.75","2430","4524","1830","600","1924","780000"
"3","2.25","2260","33080","1690","570","1974","778000"
"3","1","1220","7585","1220","0","1954","765000"
"4","2.5","4040","25752","4040","0","2000","765000"
"4","3.5","3010","174240","3010","0","2004","724950"
"2","1","1300","12000","1300","0","1959","700000"
"3","2.5","1800","4763","1240","560","1985","670000"
"4","2.75","2380","15800","1680","700","1957","655500"
"4","2.5","3420","21344","3420","0","2002","640000"
"4","2","1610","5000","1610","0","1946","630000"
"5","2.25","2520","11700","2520","0","1977","610000"
"3","2.5","2620","4800","2620","0","2002","597500"
"4","1.5","1430","6380","1430","0","1930","574500"
"2","1","1790","3760","1490","300","1912","570000"
"4","2.25","2170","7007","1540","630","1974","562000"
"4","2.75","2600","19275","1620","980","1978","555000"
"4","2.5","2550","5835","2550","0","1998","543500"
"7","2.25","2620","6890","2620","0","1961","539000"
"3","2.25","1880","100623","1880","0","1987","530000"
"4","2.5","2900","6736","2900","0","2013","527000"
"2","1","1250","5413","1250","0","1923","511000"
"4","2.25","2080","8000","1390","690","1964","500000"
"4","1","1160","20100","820","340","1913","500000"
"3","2.5","2100","4700","2100","0","1999","470000"
"3","3.5","1280","1257","1040","240","2000","470000"
"3","1","1350","10000","1350","0","1954","450000"
"3","1.75","2000","36000","2000","0","1946","443950"
"4","1.75","2410","8400","1600","810","1978","432000"
"3","1.75","1430","9750","1430","0","1962","429950"
"4","2.25","3680","26266","3680","0","1981","425000"
"3","1.5","1050","6615","800","250","1950","420000"
"4","2.5","1940","5414","1940","0","1997","420000"
"3","1","1500","3399","1300","200","1926","415000"
"4","1.75","2200","8545","1100","1100","1918","414950"
"3","1.5","1040","10323","1040","0","1958","411100"
"4","2.75","2220","8450","1260","960","1983","410000"
"3","1","960","3960","960","0","1943","405000"
"2","2.25","1140","1184","1010","130","1999","399950"
"3","2.5","1680","4075","1680","0","2008","394000"
"3","2.5","2250","8076","2250","0","1995","390000"
"4","1.75","2360","7620","1180","1180","1955","385000"
"3","1.75","2610","117176","1390","1220","1981","378000"
"3","2.25","1140","1557","1140","0","2007","375000"
"2","2.25","1240","1172","1000","240","2008","374950"
"5","2","2330","10800","1270","1060","1961","362500"
"5","2.5","2170","2752","2170","0","2014","359800"
"3","1","1200","16000","1200","0","1970","355000"
"3","2.25","1430","4777","1430","0","2010","355000"
"3","2.5","1630","5996","1630","0","1986","350000"
"3","1.75","2130","7500","1090","1040","1956","350000"
"4","2.5","2220","3561","2220","0","2014","349990"
"4","2.5","2441","7316","2441","0","2007","340000"
"4","2.5","2470","5100","2470","0","2005","337000"
"4","1.75","1700","40973","1700","0","1961","334950"
"2","1.75","1710","4187","1710","0","1987","332544"
"3","1","1290","9526","1290","0","1961","321000"
"4","2.5","2223","5780","2223","0","2010","320000"
"3","1.75","1350","217852","1100","250","1953","314000"
"3","1","1330","3740","1330","0","1903","310000"
"5","1.5","1310","4800","1110","200","1929","307000"
"6","2.5","3080","8163","1580","1500","1985","300000"
"3","2","1830","17321","1100","730","1948","295000"
"3","2.25","1610","11920","1110","500","1968","277000"
"3","1.5","1600","9072","1600","0","1963","267500"
"2","1","750","6720","750","0","1916","260000"
"3","1.75","1480","3900","1480","0","1980","250000"
"4","1.75","1510","5500","1510","0","1920","250000"
"2","1","870","8400","870","0","1960","240000"
"2","1","870","7020","570","300","1942","230000"
"3","1","960","7500","960","0","1953","200000"
"1","1","470","63737","470","0","1924","192500"
"3","1","1200","10458","1200","0","1961","190000"
"4","4.25","4500","215186","2630","1870","2009","1830000"
"5","3.5","4170","9090","4170","0","2008","1450000"
"4","3.75","2130","34689","2130","0","1955","1340000"
"4","2.75","2470","5500","1570","900","1960","1210000"
"4","2.5","3180","13118","3180","0","1986","1200000"
"5","3.75","4220","15959","4220","0","2004","1170000"
"4","3.5","4300","8406","3580","720","1987","1130000"
"5","3.5","2810","2700","1900","910","1910","999000"
"4","3.25","4110","15488","4110","0","1995","935000"
"5","3","3070","8474","3070","0","2011","825000"
"4","2.5","2760","5750","2760","0","1993","799500"
"3","2.5","2849","9588","2849","0","2001","798000"
"4","3","2170","2500","1710","460","1997","767250"
"3","2.5","1980","2975","1980","0","1993","736000"
"4","2.75","2540","4400","1630","910","1925","696500"
"3","2.5","2080","9612","1700","380","1940","689000"
"4","2.75","3310","50951","3310","0","1998","680000"
"3","2.5","2320","98445","1380","940","1978","675000"
"4","2.5","3470","6651","3470","0","2005","672500"
"5","2","1910","4667","1010","900","1908","650000"
"4","2.5","2600","6015","2600","0","2004","641000"
"4","2.5","2360","13500","1780","580","1973","600000"
"3","2.25","2210","5742","1460","750","1951","590000"
"2","1.75","1130","276170","1130","0","2006","565000"
"2","2","1930","4500","1930","0","2003","542000"
"3","2.5","1380","1389","1380","0","2008","527500"
"3","2.75","3290","11441","3290","0","1988","515000"
"3","1.75","2519","8690","2519","0","1973","505000"
"3","1","1070","4600","950","120","1930","500000"
"4","2.5","2680","10590","2680","0","2004","499000"
"3","1.75","1770","10080","1770","0","1968","495000"
"2","2.25","1160","1010","1000","160","2006","495000"
"2","1","950","3060","810","140","1925","490000"
"2","2.75","1465","972","1050","415","2006","489000"
"2","2.25","1700","2383","1700","0","2005","472500"
"4","2.75","2200","9676","1500","700","1979","460000"
"3","2.5","1780","4000","1780","0","1995","459000"
"3","1.75","1700","8360","850","850","1955","455000"
"4","3","2580","7299","2580","0","1998","449500"
"3","3.25","1710","1960","1360","350","2004","445000"
"2","1","990","4313","990","0","1917","442000"
"4","2.75","2030","56192","1550","480","1979","440000"
"3","1.75","1530","7238","1530","0","1959","418000"
"4","2.25","2200","8292","2200","0","1990","410000"
"3","1","1230","7020","1090","140","1924","410000"
"3","3.5","1450","1263","1160","290","2007","395000"
"2","2.5","1170","1394","1170","0","2001","387000"
"4","2.5","2990","6145","2990","0","2003","375000"
"3","2.5","2150","8361","2150","0","1991","371000"
"3","1.75","1530","10300","1530","0","1978","370000"
"3","2.25","1400","1320","1400","0","2006","367000"
"3","2.5","1320","4320","660","660","1918","366000"
"3","3.25","1570","2048","1290","280","2006","346500"
"4","2.5","2180","5367","2180","0","2000","339995"
"4","1.75","1660","6200","830","830","1948","320000"
"3","1.75","1680","7250","930","750","1952","315000"
"2","1","890","6350","890","0","1943","314963"
"4","2.5","2150","7944","2150","0","1990","300499"
"2","1","770","4800","770","0","1943","290000"
"3","1","1090","8280","1090","0","1947","289950"
"3","1.5","1150","11475","1150","0","1971","287000"
"3","1","1260","7660","1260","0","1947","280000"
"3","1.5","1410","9000","1410","0","1953","275000"
"3","2.25","2080","2856","1550","530","2003","267500"
"3","2.25","1740","5460","1210","530","1998","266500"
"3","1.75","1820","32666","1820","0","1966","265000"
"3","1.75","1660","7210","1660","0","1977","263000"
"3","2.5","1770","5000","1770","0","2009","255500"
"4","2","2600","9000","1410","1190","1959","250000"
"4","2","1280","7560","1280","0","1959","249000"
"3","1.5","1910","5000","1910","0","1922","247200"
"3","1.5","1290","8366","1020","270","1957","240000"
"3","1","1990","15375","1140","850","1946","234550"
"3","1.75","1100","7224","1100","0","1981","229900"
"4","2.25","1800","9350","1800","0","1969","225000"
"3","2","1460","7740","1460","0","1968","225000"
"3","1.75","1370","10866","1370","0","1945","225000"
"3","1.75","1240","7560","1070","170","1967","222000"
"2","1","1120","7797","1120","0","1948","216180"
"3","2.5","1580","8541","1580","0","1990","213550"
"3","2","1390","13464","1390","0","1987","206600"
"3","1.5","1210","10588","1210","0","1958","200000"
"3","1","1040","8645","1040","0","1962","198400"
"3","1.75","1140","9628","1140","0","1969","195000"
"3","1.5","1280","5000","1280","0","1985","187000"
"4","1","1130","13927","1130","0","1929","182200"
"2","1","1150","5695","1150","0","1958","180000"
"2","1","840","6654","840","0","1951","130000"
"2","1","700","3180","480","220","1951","119900"
"1","1","670","7957","670","0","1978","118000"
"4","3.25","3070","10375","2180","890","1962","1500000"
"5","4.25","4230","6907","3450","780","2008","1400000"
"3","1.5","1850","10572","1850","0","1953","1380000"
"5","2.75","2960","28300","2160","800","1959","1250000"
"4","2.5","2960","26742","1480","1480","1949","1160000"
"4","3.5","3850","8100","2430","1420","1995","1060000"
"3","2.25","3400","10000","3400","0","1983","970000"
"5","3.5","3400","9804","2550","850","2008","970000"
"4","2.5","3170","32430","3170","0","1989","910000"
"4","3.25","3450","6500","2450","1000","1994","850000"
"4","2.75","3160","7143","2100","1060","1933","845000"
"5","1.75","2500","11617","1560","940","1966","840000"
"3","2.5","2760","11287","2000","760","1991","830000"
"4","1.5","2040","6900","2040","0","1903","825000"
"4","3.5","3620","6499","3620","0","2003","825000"
"3","2.5","2780","175421","2780","0","2000","775000"
"3","2.25","3020","13031","3020","0","1989","755000"
"4","3.5","3370","5638","2250","1120","2001","730000"
"4","1.75","2420","520","2420","0","1900","700000"
"3","2.5","2320","219978","2320","0","1993","685000"
"5","1","2340","4730","1810","530","1918","677500"
"4","2","1930","3976","1930","0","1914","650000"
"4","2.25","2220","36085","2220","0","1989","625000"
"3","1","1180","3400","1180","0","1907","610000"
"3","2.5","1740","1251","1180","560","2012","601000"
"3","2","1800","5000","1600","200","1925","575000"
"5","1.75","2280","43560","1380","900","1949","571000"
"4","3","1490","6766","1490","0","1915","570000"
"4","2.5","3420","115434","3420","0","1989","570000"
"4","2.5","2520","11240","1440","1080","1977","560000"
"3","2.5","1550","1092","1390","160","2004","550000"
"3","1.75","1710","7350","1280","430","1981","525000"
"2","1","1420","4305","920","500","1941","490000"
"3","2","2580","15653","2580","0","1990","481000"
"2","1","1530","4370","1130","400","1946","458950"
"3","2.25","2150","9900","1450","700","1977","458000"
"4","2.25","2230","8440","2230","0","1968","449000"
"4","2.5","1980","5400","1980","0","1998","449000"
"2","1.75","860","5535","860","0","1948","442000"
"3","2.25","1760","10835","1290","470","1976","440000"
"4","2.25","2060","4670","2060","0","1975","439000"
"2","1","960","112384","960","0","1955","420000"
"3","2.75","2670","4800","2670","0","2014","408000"
"3","1.75","1470","6682","1470","0","1987","400000"
"3","1.75","1890","16001","1890","0","1950","398000"
"2","1.75","1400","2500","710","690","1916","395000"
"3","1.75","1410","7215","1410","0","1967","383000"
"3","2.5","1610","1778","1610","0","2002","380000"
"3","1","1270","6900","1270","0","1977","379950"
"4","2.5","2160","9528","2160","0","1992","360000"
"4","2.5","2050","9143","2050","0","1992","360000"
"3","1","1660","9600","1660","0","1963","360000"
"2","0.75","760","33801","760","0","1931","352000"
"4","2.5","2550","7555","2550","0","2001","340000"
"3","2.5","2588","5701","2588","0","2008","335000"
"4","3","1820","3120","1000","820","1997","320000"
"3","2","2020","7260","1180","840","1926","317000"
"3","3.25","3130","9302","2190","940","1987","310000"
"3","1","1180","8474","1180","0","1956","310000"
"3","1.5","1640","5650","1640","0","1952","303100"
"4","3","3320","13500","1750","1570","1963","302000"
"3","2.5","2090","7163","2090","0","1989","299500"
"3","2.25","1330","7200","900","430","1974","295000"
"3","1","1160","8950","1160","0","1968","294950"
"4","2.25","1740","9600","1160","580","1957","294950"
"3","2.25","1358","1141","1358","0","2007","280000"
"3","2","1560","8853","1560","0","1967","270000"
"3","2.5","1720","6271","1720","0","1993","265000"
"3","1.5","1290","7100","1290","0","1954","265000"
"3","2","1030","7260","1030","0","1947","260000"
"3","1.5","1640","8922","1640","0","1963","242000"
"2","1.75","1070","9750","1070","0","1995","241000"
"3","1","1070","5750","1070","0","1952","239300"
"2","1","1500","8015","1500","0","1947","235000"
"4","2.5","2150","7670","1240","910","1976","229950"
"3","2.5","1320","1780","880","440","2005","221000"
"3","1.5","1240","9405","1240","0","1966","215000"
"3","0.75","770","7000","770","0","1942","205000"
"2","0.75","780","5000","780","0","1945","200000"
"3","1","940","7200","940","0","1954","163500"
"5","3","3910","16200","2890","1020","1960","1560000"
"4","3.5","4150","49503","4150","0","2003","1180000"
"3","2.5","2490","24691","1580","910","1961","1160000"
"4","2.5","3430","43560","3430","0","1979","960000"
"4","2.5","3720","30649","3720","0","1988","899000"
"3","2.25","2650","12845","1770","880","1977","898000"
"3","3","3850","38830","3850","0","2000","820000"
"4","3.75","2540","20662","2540","0","1998","800000"
"5","3.25","3030","20446","2130","900","1976","790000"
"5","2.25","2910","9454","1910","1000","1972","788000"
"4","2.5","3690","13609","3690","0","1996","780000"
"3","3.5","2690","104544","2690","0","1948","775000"
"3","2.5","2020","7512","2020","0","1981","744000"
"3","2.25","2770","15886","2770","0","1982","675000"
"4","2.5","1870","16200","1250","620","1974","664000"
"4","2.5","2770","5612","2770","0","2001","650000"
"3","1","1340","4000","1340","0","1927","621000"
"2","1","990","4332","990","0","1909","620000"
"3","1.5","1630","2946","1630","0","1932","574800"
"3","3.25","1570","1777","1260","310","2007","570000"
"4","1","1360","5814","1360","0","1900","560000"
"3","1.5","1740","12000","1740","0","1974","539000"
"3","2","1840","6000","1840","0","1908","521000"
"3","2.25","2030","16200","2030","0","1984","520000"
"3","2.5","2180","9722","2180","0","1994","515700"
"3","2.5","1440","4394","1440","0","1987","515000"
"4","2","2990","102366","2990","0","1974","510000"
"3","2.25","1450","1387","1450","0","2000","497000"
"3","2.5","1650","4218","1650","0","2000","485000"
"4","2.5","2250","50155","2250","0","1998","476500"
"2","1.5","1320","10800","1320","0","1947","467000"
"2","1","850","3827","850","0","1924","447000"
"2","1","1240","8100","1240","0","1925","436000"
"2","1","870","4000","870","0","1950","435000"
"3","1.75","1820","6038","1040","780","1952","423000"
"3","1.75","1560","7245","1560","0","1962","422500"
"3","2","1680","5246","1680","0","2007","412500"
"3","1","1150","6800","1150","0","1954","410500"
"4","1","1270","3630","1270","0","1903","402500"
"3","1.75","2450","15001","1980","470","1989","399950"
"5","2.5","3004","5700","3004","0","2006","398000"
"4","2.5","1620","5280","1620","0","1924","385000"
"4","3","2120","13000","2120","0","1978","385000"
"3","0.75","1330","7020","1330","0","1924","385000"
"3","2.5","2430","7613","2430","0","1986","384200"
"3","2.5","1500","7420","1000","500","1972","379000"
"4","2","1820","8400","1300","520","1956","378950"
"4","2.5","2643","5750","2643","0","2012","376950"
"3","2","1330","1042","1060","270","2014","372000"
"2","1","830","5100","830","0","1942","350000"
"4","2.5","1980","4745","1980","0","2004","335000"
"4","1","1620","6000","1620","0","1905","327000"
"3","1.75","1660","8160","1660","0","1951","315000"
"1","2.25","1940","2550","1100","840","1979","315000"
"3","2","2610","12180","1670","940","1918","310000"
"3","2.25","1590","3056","1590","0","2001","310000"
"3","2.5","1800","3253","1800","0","2001","300000"
"3","2.25","1730","10030","1730","0","1985","300000"
"3","2.5","2070","6145","2070","0","2003","289950"
"3","2.5","1680","5000","1680","0","1987","286000"
"3","2.5","1850","8770","1850","0","1996","280017"
"1","1","790","12000","790","0","1918","248000"
"3","1.75","1240","10956","1240","0","1987","240000"
"4","2","1710","7455","1030","680","1975","234000"
"3","2","1160","1174","790","370","2007","230000"
"2","1","940","8997","940","0","1955","219950"
"3","1.5","1160","5200","1160","0","1970","210000"
"4","2","1690","7728","1690","0","1967","207000"
"2","1","970","8185","970","0","1904","204995"
"5","1.75","1660","78408","1660","0","1915","201000"
"3","1","1200","8470","1200","0","1961","178500"
"3","1.75","1720","9775","1720","0","1978","169000"
"1","1","1120","17332","1120","0","1988","166000"
"3","1.5","1280","7742","1280","0","1973","165000"
"4","1","1530","4875","1530","0","1977","164000"
"4","3.5","3500","9523","2460","1040","1996","1380000"
"5","3","3690","10260","2070","1620","1967","1130000"
"4","3.25","3570","14408","3570","0","2006","942500"
"7","3.75","5100","21802","3640","1460","2001","936000"
"4","2.5","2340","10800","2340","0","1953","880000"
"3","2","2010","7017","2010","0","1951","775000"
"4","2.75","3500","6226","3500","0","2004","775000"
"3","2","2110","5800","1990","120","1927","725000"
"3","2.5","2830","6000","1730","1100","1954","713414"
"4","2.5","3130","12463","1620","1510","1978","675000"
"4","3","2780","5000","1710","1070","1919","675000"
"4","2.5","2620","19864","2620","0","1984","650000"
"3","3.5","1494","1262","1494","0","2011","650000"
"4","2.5","2780","4200","2780","0","2001","645000"
"5","1.75","2020","6565","1120","900","1956","640000"
"4","2.5","3700","12500","1920","1780","1973","590000"
"3","2.5","3090","67082","3090","0","1990","567500"
"5","2.5","4320","107157","2160","2160","1967","565000"
"3","2.5","1870","1058","1380","490","2007","565000"
"4","2.25","2850","7453","2850","0","1991","540000"
"2","1.75","1850","3060","1060","790","1929","538000"
"3","1","1550","6840","1550","0","1918","525000"
"3","1.75","1560","6000","780","780","1944","525000"
"4","2.5","2600","9355","1840","760","1983","509000"
"4","2.25","2140","10943","1550","590","1977","502000"
"3","2.25","1380","1621","1140","240","2007","475000"
"4","3.25","4350","7090","2870","1480","1999","472000"
"1","1","1020","3200","1020","0","1927","465000"
"4","2.5","2450","20348","1410","1040","1978","450000"
"3","2.5","1260","1102","1260","0","2007","445000"
"3","2.5","1600","3172","1600","0","2002","440500"
"2","1.5","1100","1107","1100","0","2008","420000"
"5","1.5","2830","4000","2830","0","1918","405600"
"3","2.5","1430","10200","1430","0","1960","405000"
"3","1.75","1340","5100","1340","0","1953","397000"
"4","1.75","2080","8215","2080","0","1948","385000"
"3","2.25","990","736","880","110","2009","384000"
"3","1.75","1550","4050","1210","340","1988","372500"
"3","2.75","2030","6840","1210","820","1979","360000"
"2","1","840","7414","840","0","1928","360000"
"3","1","1210","6650","1210","0","1959","355000"
"4","2.5","1820","3905","1820","0","2001","330000"
"2","1","1380","5820","1380","0","1918","320000"
"2","1","780","7200","780","0","1935","315000"
"3","2.25","1720","17235","1440","280","1974","286900"
"3","1.75","1510","11234","1210","300","1965","279950"
"4","2.5","1960","7230","1960","0","2002","269950"
"3","1.75","1800","9000","1200","600","1961","257000"
"4","1","1500","11050","1500","0","1964","255950"
"3","2.25","1640","4420","1640","0","1918","250000"
"4","2","1370","8837","1370","0","1955","239000"
"3","1.5","1330","6540","900","430","1971","239000"
"3","1.75","1270","8470","1270","0","1960","237000"
"3","1","680","2400","680","0","1903","230000"
"3","1.75","1420","3000","710","710","1931","230000"
"4","1","1230","8636","1230","0","1954","195500"
"3","1.5","1180","7000","1180","0","1977","193000"
"3","1.75","1010","5355","1010","0","1950","160000"
"2","1","990","5000","990","0","1941","490000"
"3","1.75","1740","6800","1740","0","1949","450000"
"3","2.5","1610","10292","1190","420","1969","390000"
"3","2.5","1750","4076","1750","0","2013","312000"
"4","1.5","1580","6200","790","790","1944","159075"
"5","3.25","3290","6422","3290","0","2012","810000"
"3","2.5","2420","8856","1620","800","1957","755000"
"4","3.25","2557","9480","2557","0","1948","594950"
"2","1","860","5160","860","0","1909","390000"
"4","3.25","4250","18000","3350","900","1980","2200000"
"5","2","2500","15250","2500","0","1942","1700000"
"3","2.25","2420","7200","1420","1000","1948","1100000"
"4","2.25","2630","4000","1810","820","1909","1050000"
"5","3.25","4240","9588","4240","0","2014","1050000"
"4","3.5","4270","117176","4270","0","2008","997950"
"5","4.5","4230","9701","4230","0","1999","935000"
"4","3.75","4420","9492","3420","1000","1962","925000"
"4","2.75","3030","18400","2360","670","1973","901000"
"4","2.75","3040","13559","3040","0","2003","840000"
"5","2.25","2710","19800","1910","800","1959","830000"
"4","2","1760","4500","1760","0","1906","720000"
"3","1.5","1670","5060","1670","0","1925","715000"
"4","1","1550","15239","1370","180","1930","685000"
"3","2","2040","4841","1020","1020","1949","667500"
"3","1","1710","5992","1560","150","1928","650000"
"4","1.75","1930","10210","1670","260","1941","630000"
"3","1.75","1720","7200","1420","300","1959","622200"
"4","2.5","1900","9775","1900","0","1967","620000"
"4","2.25","1660","7350","1660","0","1965","610000"
"2","1","1550","3200","1550","0","1927","605000"
"4","2.25","2090","45738","2090","0","1987","600000"
"3","3.5","2710","3290","1650","1060","2006","600000"
"3","2.5","3040","7880","3040","0","2004","598555"
"3","2","1980","3478","1440","540","1929","555000"
"3","2.5","2678","6607","2678","0","1998","546200"
"4","2.5","3000","5471","3000","0","2013","540000"
"4","1","1920","6480","1920","0","1920","535000"
"3","1.75","1660","4800","960","700","1941","530000"
"3","2.5","1365","1090","1315","50","2003","530000"
"3","1.5","1350","6000","900","450","1950","525000"
"4","2","2090","4000","1480","610","1951","513000"
"2","1.75","1700","5000","850","850","1915","511718"
"3","2.5","2540","5237","2540","0","2011","489950"
"6","3.25","4750","248600","4750","0","1947","487000"
"4","1","1210","6380","1210","0","1936","485000"
"4","1.5","1220","3780","1220","0","1927","483000"
"5","2","2030","9804","1110","920","1963","472000"
"2","1","730","2600","730","0","1918","465000"
"3","1.75","1660","9900","1660","0","1978","460000"
"3","2.5","2480","5647","2480","0","2002","450000"
"4","2.5","2660","8027","2660","0","1997","447000"
"2","2.75","1100","1088","750","350","2006","440000"
"3","2.5","2530","16102","2530","0","1989","435000"
"4","3.75","2452","4800","2452","0","1936","430000"
"4","1","1510","1501","1510","0","1906","420000"
"3","2","2010","33090","2010","0","1986","415000"
"3","1.5","1330","9900","1330","0","1956","400000"
"4","1.75","2330","8364","2330","0","1968","390000"
"3","1.5","1340","6500","1340","0","1972","387000"
"1","0.75","760","10079","760","0","1936","369900"
"2","1","840","10800","840","0","1909","361500"
"3","1.75","1510","6000","1060","450","1947","360000"
"4","2.25","2620","8100","1550","1070","1964","360000"
"3","0.75","1420","3060","860","560","1923","355000"
"3","2.5","2180","15484","2180","0","1992","350000"
"3","2.5","2140","7641","1290","850","1979","339950"
"3","2.5","1990","3694","1990","0","1989","334500"
"3","1.75","1320","4548","1320","0","1977","333500"
"4","2.5","2050","10271","2050","0","1998","331500"
"3","3.25","1290","1153","1290","0","2008","331000"
"3","2","2500","10697","2500","0","1994","330000"
"4","2.75","2130","9339","1330","800","1991","325250"
"4","2.5","1940","7107","1940","0","2000","322500"
"4","2.5","2620","5457","2620","0","2003","321500"
"3","1.75","1460","7884","1460","0","1975","315000"
"3","1.75","1340","12800","880","460","1981","315000"
"3","1.75","1170","4000","720","450","1943","315000"
"4","2.25","1880","9163","1880","0","1981","315000"
"2","1","720","1716","720","0","1941","314000"
"3","2.25","1646","7364","1646","0","1994","307500"
"2","1","1390","19988","1390","0","1949","306500"
"2","1","1570","125452","1570","0","1953","299990"
"3","1.5","1190","9135","1190","0","1959","299000"
"4","2.5","2350","6958","2350","0","1998","299000"
"2","1","1010","7740","890","120","1924","289000"
"2","1.5","1160","2158","1160","0","1982","289000"
"4","2.25","2250","12000","2250","0","1985","287500"
"3","1.75","2440","10179","1220","1220","1962","280500"
"3","2.25","1340","7202","1340","0","1989","279950"
"3","1.75","2710","9088","2060","650","1965","278000"
"3","3","1590","7750","1060","530","1997","275000"
"3","1.25","1230","4500","1230","0","1913","275000"
"3","2.5","3030","45004","3030","0","1987","274975"
"4","3","1840","7510","1840","0","1988","268000"
"4","2.5","2110","8990","2110","0","1977","260000"
"3","2","1990","203861","1990","0","1949","246000"
"4","1","1620","17500","1620","0","1962","218000"
"3","1.5","1690","9600","1210","480","1976","212000"
"3","2.25","2140","9775","1470","670","1978","210000"
"3","1","910","7194","910","0","1971","182500"
"3","1.75","1910","17003","1910","0","1963","175000"
"3","1","1310","9529","1310","0","1956","170000"
"3","1.5","970","8400","970","0","1966","155000"
"2","1","1220","7250","1220","0","1914","135000"
"3","1","1260","7500","1260","0","1954","120000"
"3","2","3620","14250","3220","400","2007","1580000"
"3","3.5","3530","3610","2370","1160","2008","1500000"
"5","3.25","4020","4500","3120","900","2010","1420000"
"4","3","3520","128502","3520","0","1981","1400000"
"3","2.75","2780","4815","2780","0","1974","1250000"
"4","2.5","3120","49456","2590","530","1974","1230000"
"4","2.5","2780","6837","2780","0","2004","1090000"
"4","2.75","2940","5400","1940","1000","1910","1010000"
"3","2.25","2370","10890","2370","0","1980","943500"
"4","2.25","2800","18673","1650","1150","1965","940000"
"5","2.5","3150","35283","1800","1350","1975","935000"
"3","3","3030","5156","2080","950","1929","879000"
"4","4","2790","16117","2790","0","1999","865000"
"4","2.75","3300","4987","3300","0","2014","849990"
"4","2.5","2880","35610","2880","0","1989","845000"
"4","2.25","2100","3671","1750","350","1929","840000"
"5","3","2920","2808","2140","780","1960","830000"
"3","2.5","3760","5260","3230","530","2002","825000"
"3","1.5","2310","3360","1790","520","1926","817000"
"4","2","1400","4800","1400","0","1986","815000"
"3","2","2190","5400","1260","930","1952","769950"
"3","2.25","3190","324086","3190","0","1982","765000"
"3","2.5","4040","147856","4040","0","2004","760000"
"3","2.75","1960","6390","1960","0","1900","759000"
"3","2.75","3010","206910","3010","0","2001","750000"
"4","2.5","2440","9727","2440","0","1987","749500"
"3","2.5","2960","9350","2960","0","1978","740000"
"4","2.5","2880","12349","2880","0","1996","710000"
"4","1.75","2390","5880","1390","1000","1957","695000"
"3","1","1570","2280","1570","0","1922","685000"
"4","2.75","2550","4950","2550","0","1989","669888"
"4","3","3640","5096","2740","900","2010","630000"
"3","2.75","3200","12682","3200","0","1977","618000"
"4","2.5","2480","5000","2480","0","2004","599000"
"7","1.5","2670","11250","2320","350","1948","575000"
"4","2.75","1690","6090","1400","290","1945","550000"
"3","2.25","2090","8095","2090","0","1988","550000"
"3","2.5","2550","10355","2550","0","1990","547500"
"3","2.5","3550","136343","3550","0","1977","545000"
"3","1.75","1330","5000","1210","120","1909","532500"
"3","2.5","1860","43170","1860","0","1986","526500"
"3","2.5","2160","4297","2160","0","1999","520000"
"2","1.5","1840","3825","1040","800","1928","520000"
"3","2.5","1510","1178","1060","450","2007","515000"
"3","2.5","1690","1479","1420","270","2005","492000"
"2","1.75","1670","4200","1670","0","1912","490000"
"2","1","1000","4956","1000","0","1916","484950"
"2","1.75","1400","4720","820","580","1927","483000"
"4","2.5","3230","16171","2520","710","2001","480000"
"3","2.25","1630","3070","1630","0","2004","476000"
"3","1","1280","10000","1280","0","1954","473000"
"4","3","2230","108900","1410","820","1978","460000"
"4","2.75","1540","4840","850","690","1929","450000"
"2","1","1340","7250","1340","0","1951","450000"
"2","1","930","3150","930","0","1918","445000"
"5","2","2610","5009","1710","900","1988","439000"
"3","2","2320","9420","2320","0","1952","436300"
"3","2.25","1380","3015","1380","0","2009","435000"
"3","2.25","1470","1703","1470","0","2005","430000"
"5","2.5","2720","8120","1360","1360","1970","429000"
"4","2.5","3160","8726","3160","0","1999","427500"
"3","2","1330","5632","1330","0","1988","424000"
"3","1.75","2390","11242","1290","1100","1959","420000"
"4","2.5","2150","8173","2150","0","1987","415000"
"3","1","1690","6658","1690","0","1942","400000"
"2","1.75","960","6200","960","0","1946","400000"
"5","2","2620","7030","1420","1200","1965","399000"
"3","1","1480","5100","1480","0","1938","397500"
"2","1","1030","5072","1030","0","1924","397380"
"3","2","1440","3900","1440","0","2002","391265"
"3","2","1510","10827","1510","0","1984","390000"
"4","2.5","2420","9147","2420","0","1998","389000"
"3","2.5","1710","5633","1710","0","1981","372000"
"3","1.75","1620","37913","1620","0","1953","370000"
"4","2.5","2050","4502","2050","0","2005","369950"
"2","1","2020","6720","1010","1010","1948","355000"
"2","1","800","8775","800","0","1942","353500"
"4","2","2080","6360","1330","750","1960","352800"
"3","1.75","1900","10225","1220","680","1963","350000"
"4","2.25","2390","13002","2390","0","1987","350000"
"4","2.5","1800","7620","1800","0","1995","349000"
"2","1","1280","9134","640","640","1919","340000"
"3","2","1420","6060","830","590","1942","340000"
"5","2.5","2070","4698","2070","0","1999","337500"
"3","2.25","1620","7150","1280","340","1950","330000"
"4","3","2290","8250","2290","0","1990","328500"
"3","2.5","1940","8347","1940","0","1990","324000"
"3","1.75","1400","18002","1400","0","1977","322000"
"2","1","1210","7040","1210","0","1952","320000"
"2","2.25","1290","2436","1290","0","1984","315000"
"2","1","1180","4900","1180","0","1954","313000"
"2","1","1460","1716","1260","200","1925","312000"
"3","1","1250","7320","1250","0","1968","309500"
"2","1","1080","6250","1080","0","1942","308000"
"2","1.75","1460","10506","1460","0","1983","299950"
"2","1","750","5026","750","0","1942","292500"
"3","1.75","1590","13500","1090","500","1980","290000"
"3","1.75","1460","7980","1460","0","1972","290000"
"4","3.5","2770","10505","2770","0","1940","285000"
"3","2.25","1820","19602","1820","0","1964","277500"
"3","2.25","1820","9766","1450","370","1987","275000"
"3","2","1936","6612","1936","0","2014","274900"
"3","2","1510","10215","1510","0","1995","270000"
"3","1.75","1590","7148","1590","0","1952","259000"
"4","1.75","1650","7200","1100","550","1977","255000"
"2","2","1140","1118","1040","100","2009","247300"
"4","1.75","1720","7455","1020","700","1963","246000"
"3","2","1690","6790","1360","330","1979","245000"
"3","2.25","1500","15334","1500","0","1992","240000"
"2","2","870","6450","740","130","1954","235000"
"4","1.5","1050","9516","1050","0","1969","230000"
"3","1.75","1730","7200","1730","0","1944","226450"
"2","1","970","5600","970","0","1951","217000"
"3","1.75","1100","5525","1100","0","1968","209950"
"3","1","1050","5233","1050","0","1906","206000"
"2","1","1060","5144","1060","0","1969","202950"
"2","1","1000","5026","760","240","1915","159995"
"4","3.5","4440","8125","3140","1300","1922","2250000"
"4","3.75","3320","8234","3320","0","2014","1700000"
"5","4.25","3350","3600","2260","1090","2014","1430000"
"5","3.75","3330","5042","2470","860","2014","1380000"
"5","2.5","2810","6000","2810","0","1907","1170000"
"3","3.25","2990","189852","2990","0","1974","1060000"
"5","4","4180","7232","4180","0","2014","1040000"
"5","3","3730","5500","2160","1570","1927","979700"
"5","4","4100","8120","4100","0","2011","950000"
"4","2.5","2620","14126","1620","1000","1941","922000"
"2","1","1530","6350","1530","0","1923","880000"
"4","2.5","2710","4069","2710","0","1990","865000"
"4","1.75","1820","4500","1820","0","1921","815000"
"5","3.5","3550","9600","2550","1000","1998","810000"
"4","3.25","4360","91158","3360","1000","1993","795127"
"5","3","2370","6000","1340","1030","1926","770000"
"3","2.5","2200","3000","1530","670","2002","740000"
"4","2.5","2830","5010","2170","660","2000","738000"
"4","2.75","2660","7389","2660","0","2002","695000"
"5","2","2140","5000","2020","120","1913","680000"
"3","2.5","1610","1246","1080","530","2014","659950"
"3","2","2680","8429","1880","800","1950","653000"
"3","1.75","1660","10819","1240","420","1942","650000"
"10","2","3610","11914","3010","600","1958","650000"
"4","1.5","2550","4000","1760","790","1926","645000"
"4","2.5","3220","14463","3220","0","1978","630000"
"3","1","1800","4800","900","900","1927","625000"
"4","2.25","2200","7200","1220","980","1958","610000"
"3","2.5","1760","1472","1640","120","2006","608000"
"3","2.5","1350","187313","1350","0","1997","600000"
"2","1.75","1280","8500","1280","0","1953","595000"
"4","1.5","2230","208652","1330","900","1918","590000"
"3","1.75","2310","7620","2310","0","1942","588000"
"5","1.75","2330","4947","1380","950","1955","572500"
"3","2.5","2320","57063","1790","530","1979","568000"
"3","2.5","1280","1920","1280","0","2009","552000"
"1","1.5","1900","40600","1450","450","1977","550000"
"3","2.5","2250","9235","2250","0","1985","549000"
"4","2.25","2620","33578","2620","0","1977","535000"
"4","2.25","1990","7610","1290","700","1966","529219"
"3","1.5","3430","264844","2230","1200","1988","524500"
"3","2.5","1860","3658","1860","0","1994","510000"
"4","2.5","4060","8547","2790","1270","2007","495000"
"3","2.25","1780","8050","1230","550","1979","495000"
"3","2.25","1840","10500","1840","0","1993","481500"
"3","2.5","2450","28185","2450","0","1990","480000"
"4","2.5","2520","9684","2520","0","1994","470000"
"3","2.5","1990","4978","1990","0","2004","467000"
"3","3","2290","15600","1420","870","1948","465000"
"3","1.75","1590","1322","1060","530","2014","465000"
"3","2.5","1180","932","1180","0","2010","455000"
"2","2.5","1260","1131","1260","0","2006","452000"
"3","2.5","2280","4557","2280","0","2010","450000"
"3","2.25","2120","6710","1420","700","1959","436000"
"4","2.5","2190","6578","2190","0","2004","435000"
"3","2.75","1690","5763","1180","510","1985","410000"
"2","1","1140","101529","1140","0","1932","400000"
"3","3.25","1680","1478","1360","320","2009","399000"
"5","1.75","1610","15246","1610","0","1936","393000"
"3","1.5","1610","13500","1060","550","1970","390000"
"5","3.5","2960","12527","1940","1020","1986","389500"
"3","1.75","1810","10800","1210","600","1968","387000"
"1","1","710","6000","710","0","2015","385195"
"4","2.25","2200","6750","1480","720","1959","376000"
"4","3.25","2290","4785","2290","0","2007","359950"
"2","1","1350","368517","1350","0","1947","355000"
"4","2.5","2100","8501","2100","0","1993","344000"
"3","3","1260","1634","1260","0","1998","342000"
"3","2.25","2630","9916","2630","0","1988","340000"
"3","1.75","1420","6289","1100","320","1967","329922"
"3","2.5","2040","9765","2040","0","1985","325900"
"3","1","1490","57381","1490","0","1932","325000"
"3","3.25","1380","1225","1380","0","2000","322000"
"4","2.5","1950","3225","1950","0","2002","315000"
"3","1","1980","39150","1580","400","1932","308000"
"3","1","1410","81021","1410","0","1949","299950"
"3","2","1730","6007","1730","0","2004","299000"
"2","1.5","1430","1650","1430","0","1999","297000"
"5","2.75","1790","5000","1060","730","1915","294000"
"3","2.5","1190","8175","1190","0","1986","290000"
"4","1","1190","8875","1190","0","1946","276693"
"3","2.25","1780","7332","1780","0","1987","272450"
"3","2","2330","8000","1390","940","1986","270000"
"3","3.5","1790","1682","1480","310","2006","246950"
"3","1","1020","8625","1020","0","1978","245000"
"5","1.75","2460","16000","1230","1230","1957","240000"
"3","2","1400","8821","1400","0","1991","231200"
"4","1.75","1540","7200","1260","280","1966","221000"
"3","1","1210","10185","1210","0","1957","205000"
"4","1.5","2170","9948","2170","0","1952","195000"
"3","1","1090","3523","1090","0","1969","152500"
"3","1","840","12091","840","0","1959","96500"
"4","4.25","4470","5884","3230","1240","2010","2950000"
"4","3.5","5490","14300","2910","2580","1996","1790000"
"4","2.5","2800","4000","2800","0","2011","1470000"
"4","2.5","2900","21074","2900","0","1986","1340000"
"3","2.25","2640","7544","2640","0","1995","1220000"
"3","2.5","3420","16622","2410","1010","1991","1200000"
"4","2.5","2910","8881","1940","970","1932","1100000"
"5","2.25","2960","7680","1550","1410","1958","1050000"
"3","2.5","2710","23292","2080","630","1956","999000"
"4","3.5","3200","8049","2700","500","1980","935100"
"5","3.25","3620","5500","3620","0","2003","856000"
"4","3","2390","4000","1460","930","1931","845000"
"3","2.5","2990","10711","1560","1430","1976","820000"
"3","1.75","2080","11866","2080","0","1960","813000"
"3","3","2840","206910","2840","0","1999","790000"
"4","2.5","3560","6187","3560","0","2003","770000"
"4","2.5","2540","5760","2540","0","2009","759990"
"3","2","2260","7200","1130","1130","1941","759000"
"4","2.5","3210","8938","3210","0","2005","750000"
"4","2.25","2490","6973","1490","1000","1953","704000"
"4","2.25","2440","9450","2440","0","1947","700000"
"4","2.5","2790","5423","2790","0","1999","685100"
"3","2","2210","5000","1710","500","1909","685000"
"3","2.5","1780","4320","1780","0","1930","679000"
"3","1.75","1240","13869","1240","0","1957","675000"
"5","2.5","2820","14062","2380","440","1960","669950"
"4","1.75","2680","6120","1340","1340","1959","622000"
"3","3.25","2440","2812","1710","730","2005","613000"
"3","3","1560","2091","1560","0","2006","598500"
"3","2.25","1670","7416","1220","450","1974","580000"
"3","1.5","1800","6250","1420","380","1947","580000"
"3","1.75","1250","4120","980","270","1925","579500"
"2","1","1070","2754","830","240","1924","579100"
"5","3.25","2360","3873","1990","370","2006","569900"
"4","1","1170","4590","1170","0","1925","564000"
"3","1.75","1770","8050","1020","750","1963","538000"
"4","2.5","2590","9530","1640","950","1978","537250"
"2","1","1840","4322","1160","680","1914","513000"
"2","1","2180","9300","1090","1090","1947","490000"
"3","2.75","1820","9490","1820","0","1994","488500"
"2","1","820","4488","820","0","1939","478000"
"3","1","1580","3774","1580","0","1900","465000"
"3","1.75","1730","7807","1260","470","1976","459000"
"4","2.25","1710","7000","1040","670","1972","450000"
"5","2.75","2710","6220","2710","0","2014","450000"
"3","2.25","1440","4667","1440","0","1985","447000"
"3","1.75","2110","4800","1210","900","1956","445000"
"3","1","1560","5225","1260","300","1927","430000"
"3","2.5","1710","4920","1710","0","1990","415000"
"2","2.5","1700","6635","1700","0","1976","407000"
"2","1","1270","3700","1270","0","1909","404500"
"3","2.25","1780","9672","1350","430","1960","395000"
"3","2.5","2510","5320","2510","0","2005","395000"
"3","2.5","1580","5725","1580","0","2004","375000"
"2","1","970","10423","970","0","1947","345000"
"2","2.25","1110","1290","1110","0","2006","345000"
"3","2.5","3070","5871","2510","560","1928","340500"
"2","1","800","3090","800","0","1925","339950"
"3","1.75","2020","11050","1320","700","1969","330000"
"3","2","1670","17071","1100","570","1988","325000"
"3","1.75","2500","8289","1250","1250","1958","315000"
"2","1","840","892","840","0","2006","306500"
"3","2.5","2530","8669","2530","0","1990","299250"
"5","2.75","2300","7600","1400","900","1969","294000"
"2","1","760","6000","760","0","1950","289950"
"4","2.5","1560","4350","1560","0","2003","280000"
"3","2","1910","8050","1000","910","1980","275000"
"4","2.5","2490","11650","1390","1100","1990","270000"
"3","1","1320","8100","880","440","1943","268950"
"3","1","1190","11120","1190","0","1947","260000"
"5","2","2260","12500","1130","1130","1960","258000"
"4","2","1470","7412","1470","0","1967","250000"
"2","2","1470","2541","1470","0","2005","249900"
"4","2.5","1630","3060","1630","0","2003","236000"
"6","3","2180","7220","2180","0","1980","230000"
"3","1","1020","12289","1020","0","1967","230000"
"3","1.75","1460","8372","1460","0","1981","225000"
"2","1","830","5720","830","0","1950","225000"
"3","1.75","1230","7200","1230","0","1986","220000"
"3","1","860","6664","860","0","1944","219900"
"3","1","1400","6600","1280","120","1954","214950"
"3","2.25","2190","8834","1390","800","1987","194250"
"2","1.75","1340","7380","1340","0","1940","192000"
"3","1","1270","8508","650","620","1942","134000"
"2","1","760","4746","760","0","1930","110000"
"5","2.75","3090","19865","3090","0","1953","1450000"
"4","4.5","3080","10550","1940","1140","1976","1400000"
"5","3.25","3540","5971","2000","1540","2005","1350000"
"3","2.75","3860","12786","3860","0","1984","903000"
"4","2.5","2570","4480","1580","990","1927","889000"
"3","2.25","2290","9047","2290","0","1984","753000"
"3","2.5","2160","8809","1540","620","2014","730000"
"4","1","1870","4992","1670","200","1940","730000"
"3","2","1820","4480","1120","700","1923","655000"
"3","2.25","1940","7482","1240","700","1964","635000"
"4","3.25","2885","5562","2885","0","1984","605000"
"3","3.5","2514","1559","2024","490","2007","575000"
"5","2.75","2510","28185","1600","910","1963","569950"
"4","2.5","2620","10016","2620","0","1996","565000"
"3","1.75","1590","2500","1190","400","1908","556000"
"4","2.5","2060","8451","2060","0","1995","543000"
"2","2.25","1530","981","1480","50","2006","520000"
"3","2.5","2100","7851","2100","0","1986","515000"
"3","2.5","1861","1587","1578","283","2007","499000"
"4","2.5","2460","4862","2460","0","2004","495000"
"4","2.5","2650","9627","1610","1040","1976","490000"
"3","2.5","1840","8250","1340","500","1958","485000"
"3","2.5","2480","6031","2480","0","2001","475000"
"3","3","1530","1568","1530","0","2012","474950"
"3","1.75","1310","8600","1310","0","1987","470000"
"2","2.5","1380","1329","1050","330","2008","457000"
"3","1","1480","4200","1480","0","1925","427500"
"3","2.5","1670","22703","1310","360","1988","415900"
"2","1","840","8100","840","0","1948","401000"
"3","2","1350","7216","1350","0","1964","400000"
"3","1.75","1300","12378","1300","0","1943","380000"
"4","2.75","2420","39704","2420","0","1985","370000"
"4","2.5","2542","6120","2542","0","2014","359950"
"4","2.5","2020","32710","1070","950","1941","340000"
"4","2.75","2475","4000","2475","0","2014","335900"
"3","1.75","1560","9514","1560","0","1967","285000"
"3","2.25","1520","7930","1160","360","1988","270000"
"5","2","1730","7375","1730","0","1944","249950"
"3","1.75","1340","8250","1100","240","1985","230000"
"4","2","1460","7254","1460","0","1959","150000"
"4","2.75","3560","8975","3560","0","2014","1750000"
"4","2.5","2990","5342","2990","0","2004","644500"
"3","2.5","1740","3690","1740","0","2000","399000"
"3","2.5","1250","864","1250","0","2004","353000"
"3","1.75","2090","6258","1390","700","1956","350000"
"4","2.5","2560","4000","1610","950","1929","825000"
"4","4","4500","11795","4500","0","1991","1520000"
"4","4.25","5710","24663","5710","0","2007","930000"
"3","2.25","2520","7975","1550","970","1990","825000"
"4","2.75","3470","70131","1750","1720","1962","772000"
"4","2.5","2860","9159","1530","1330","1989","750500"
"3","1.75","2145","3840","2145","0","1910","734000"
"5","2.5","2900","9525","2900","0","1989","720000"
"3","2.5","2510","4106","2510","0","2003","699950"
"3","2.25","2420","5304","1640","780","1947","697000"
"3","2.5","2820","5001","2820","0","2004","690000"
"4","2","2340","6000","1270","1070","1953","685000"
"4","2.5","2590","9753","2590","0","1993","674750"
"3","2.25","2780","31510","2780","0","1979","666000"
"3","2.25","1570","1680","1570","0","2014","660000"
"2","1.5","1900","4450","1500","400","1916","650000"
"4","2.75","2850","7510","2850","0","2008","637000"
"4","2.5","2670","5974","2670","0","1999","612000"
"5","2.25","3220","9603","3220","0","1972","605000"
"5","2.25","2680","13292","1340","1340","1976","599950"
"3","1.75","1650","1180","1650","0","2014","599000"
"3","1","1450","5378","1190","260","1939","585000"
"5","2.5","2090","8712","1420","670","1966","555000"
"3","1.5","1340","6000","1340","0","1960","550000"
"3","2","1280","960","1040","240","2014","549900"
"2","1","1200","2500","1090","110","1927","508000"
"4","2.25","2730","35100","2730","0","1977","500000"
"3","3.5","1650","1577","1100","550","2012","495000"
"4","2","2180","10575","1730","450","1950","480000"
"5","1.75","2080","217800","2080","0","1963","480000"
"3","3.25","1430","1348","1160","270","2008","478000"
"4","2","2000","6250","1480","520","1930","465000"
"4","2.5","1320","7000","1320","0","1956","455000"
"4","2.5","2190","6896","2190","0","2007","452000"
"3","1.75","1950","6504","1530","420","1953","447500"
"4","2.5","2130","10375","2130","0","1986","435000"
"4","1.75","2290","4400","1290","1000","1959","435000"
"3","1.75","1660","12865","1660","0","1967","431000"
"4","2.75","2350","5589","2350","0","2001","426950"
"3","2.25","1260","3000","1260","0","2003","425000"
"3","2.5","2655","5080","2655","0","2013","409950"
"3","2.5","1400","4400","1400","0","1930","399950"
"2","2.5","1780","1311","1350","430","2005","398500"
"4","1.75","1950","10219","1950","0","1962","395000"
"2","1.5","1240","1331","1050","190","2007","379900"
"3","1","1780","5236","1050","730","1944","375000"
"2","2","2100","58488","2100","0","2005","370000"
"3","1","1110","7603","1110","0","1967","369950"
"2","1.5","790","1123","700","90","2003","365000"
"2","2","920","1201","800","120","2009","363000"
"4","2.5","3200","5772","3200","0","2003","337000"
"5","1.75","2590","6720","1750","840","1979","334000"
"3","1.75","1120","98445","1120","0","1917","316000"
"3","1","1510","10369","1010","500","1968","313000"
"5","2.25","2660","8400","2660","0","1961","305000"
"2","2","1320","2040","1320","0","1997","296000"
"2","1","1300","39639","1300","0","1960","295000"
"3","2.5","1950","7421","1950","0","1996","292000"
"2","1.75","1560","7575","1560","0","2002","290000"
"4","2.25","1660","7184","1110","550","1963","277500"
"3","1","800","5760","700","100","1949","265000"
"3","2.25","1450","13439","1180","270","1963","265000"
"4","2.25","1600","6202","1600","0","1986","257700"
"3","1","1580","8240","1040","540","1978","253000"
"3","2.25","1620","10850","1620","0","1966","250000"
"2","1","800","5220","800","0","1943","250000"
"3","2","1670","4438","1670","0","2014","249950"
"3","2.5","1470","9337","1470","0","1991","244000"
"2","1","810","4838","810","0","1938","238950"
"3","1","1250","7592","1250","0","1961","235000"
"3","2","1710","4697","1710","0","1941","233000"
"3","1","1230","12201","1230","0","1969","210000"
"2","1","790","7128","790","0","1944","189000"
"3","1","1070","8250","1070","0","1961","164000"
"4","3.5","3500","4000","2560","940","2000","1050000"
"3","2.5","2450","4400","1800","650","1922","952000"
"6","3.25","3140","14923","3140","0","1991","925850"
"4","3.5","3560","4951","3560","0","2014","922755"
"3","3.5","3940","11632","3940","0","2014","857326"
"4","2.5","3370","5000","3370","0","2006","825000"
"4","1.5","1790","3952","1790","0","1932","800000"
"5","1.75","1920","6500","1260","660","1951","715000"
"3","2","2360","6149","1560","800","1926","690000"
"5","2.75","2330","8000","1550","780","1972","665000"
"3","2.25","2280","6150","2280","0","1984","660000"
"3","2.5","2990","32239","2990","0","1978","632925"
"2","1","1270","5100","1100","170","1900","611000"
"3","2.25","2060","31400","2060","0","1984","560000"
"4","2.25","1650","7200","1650","0","1967","550000"
"2","1","1657","5031","1657","0","1910","546000"
"4","2.5","3250","4500","3250","0","2008","530000"
"3","1","1430","3455","980","450","1947","511000"
"4","2","1960","2166","1260","700","1926","509000"
"3","2.5","1870","9135","1250","620","1984","502000"
"4","2.5","3010","5040","3010","0","2006","500000"
"3","1.75","1890","6557","1890","0","1967","495000"
"4","1.75","1920","1137","1470","450","1966","481000"
"3","2.5","2420","36862","1530","890","1957","475000"
"2","1","840","5000","840","0","1908","457500"
"4","2.5","2400","6811","2400","0","2007","456500"
"6","4","2280","5275","1270","1010","1998","449500"
"4","1.75","2100","4400","1720","380","1924","445000"
"4","2","2630","9663","1330","1300","1956","435000"
"4","3.25","3760","4675","2740","1020","2007","429900"
"4","1.5","1620","7875","1620","0","1956","425000"
"3","2.25","2280","200811","2280","0","1978","410000"
"4","2.5","2090","6667","2090","0","1997","405000"
"4","1.75","1850","6480","1120","730","1958","400000"
"3","1.75","1830","27468","1830","0","1954","398000"
"3","2","1710","134489","1710","0","1952","397000"
"4","2.5","2300","41167","2300","0","1988","392000"
"3","1.5","1650","8676","1130","520","1979","390000"
"3","1.75","2200","8036","1270","930","1978","390000"
"3","2.5","1760","5390","1760","0","2014","382495"
"2","1","1430","7819","1110","320","1944","380950"
"3","2.5","1840","6985","1290","550","1971","380000"
"2","1","980","3400","980","0","1923","380000"
"4","1.75","1700","8640","850","850","1955","378500"
"4","1.75","2160","7417","1360","800","1983","355000"
"6","3.5","3020","4500","3020","0","1941","354000"
"3","1.75","1380","4590","930","450","1950","350000"
"3","1.75","1690","5080","1190","500","1976","349000"
"3","1","960","3844","960","0","1972","345000"
"4","1.75","2140","11651","2140","0","1930","340000"
"4","1.75","1440","6144","720","720","1947","339888"
"3","1","1160","9525","1160","0","1968","325000"
"3","2","1550","8300","1550","0","1965","300000"
"3","1.75","1880","11700","1880","0","1968","299500"
"1","1","520","5600","520","0","1918","295000"
"3","1","1380","7575","1380","0","1963","295000"
"3","1.75","1420","1361","960","460","2014","294000"
"7","1","2350","8636","1550","800","1962","291000"
"4","1.75","2090","12750","1360","730","1967","290000"
"3","1.75","1580","9750","1580","0","1954","289000"
"4","2.5","2050","7416","2050","0","1990","280000"
"4","2","1480","15000","1480","0","1957","275000"
"4","1.75","1840","10528","1210","630","1990","274900"
"4","2.25","1880","6160","1880","0","1993","272000"
"3","1.75","1397","18000","1397","0","1965","257000"
"3","1","1150","10000","1000","150","1951","241000"
"4","2","1980","10585","1980","0","1924","239000"
"3","2.5","1650","2807","1650","0","2004","238000"
"4","2.75","1770","10184","1250","520","1979","235000"
"3","2","1510","3413","1510","0","1985","230000"
"2","1","940","15000","940","0","1960","225000"
"3","1","840","4495","840","0","1921","151100"
"4","3.25","3480","6000","3480","0","2014","1850000"
"3","2.75","3340","12690","2550","790","1956","1300000"
"3","1.75","2320","6090","2040","280","1939","1070000"
"4","3.5","2840","5900","1920","920","1910","986000"
"4","3.25","4030","57499","4030","0","2002","929000"
"5","2.75","3210","8001","3210","0","2014","924000"
"3","2.5","3050","12558","3050","0","1997","865000"
"2","2","2640","13939","1640","1000","1963","850000"
"5","2.5","2800","11325","1400","1400","1970","850000"
"4","4","3430","35102","2390","1040","1986","832500"
"4","2.75","2390","6820","2140","250","1945","799000"
"4","2.75","2070","10125","1390","680","1962","741000"
"3","2.25","3440","44374","2190","1250","1979","740000"
"4","2.5","2270","7665","2270","0","1986","732350"
"4","2.5","4070","9870","4070","0","1998","710000"
"4","2.25","2450","34092","2450","0","1980","682000"
"3","2","1870","3388","1230","640","1925","650000"
"3","2.5","2350","3750","1740","610","2003","650000"
"4","2.5","2980","12764","2980","0","1994","649000"
"4","2.5","4260","36360","4100","160","1935","635000"
"5","2","2270","2400","2270","0","1905","631000"
"3","1.5","1740","9840","1740","0","1963","616000"
"5","3.25","2590","6180","1330","1260","1960","599000"
"4","1.75","1760","5356","920","840","1950","585000"
"3","2","1870","5300","1870","0","2009","580000"
"5","2.25","3550","7992","3550","0","1968","575000"
"3","2.5","2270","9600","2270","0","1990","575000"
"3","2.5","2280","12498","2280","0","1987","560000"
"4","1.75","1560","9000","1560","0","1969","544300"
"3","2.5","2990","6725","2990","0","2003","525000"
"3","2.25","2590","9263","1440","1150","1977","520000"
"3","3","2260","2400","2260","0","1909","512500"
"4","2.5","2940","156988","1870","1070","1996","503000"
"3","2.5","1910","5562","1910","0","1988","496600"
"3","2.5","2220","60984","2220","0","1987","475000"
"3","2.75","1890","2614","1890","0","1979","462000"
"3","2.5","2430","7049","2430","0","2007","443000"
"2","2","1440","1170","960","480","2004","435000"
"3","2","2360","12744","2360","0","1964","435000"
"3","1.75","2380","3200","1190","1190","1956","415000"
"2","1","890","3271","890","0","1918","409000"
"4","2.5","2620","8960","1520","1100","1955","405000"
"3","1.5","1310","2996","1310","0","1998","398000"
"3","1","1250","21303","1250","0","1970","385000"
"3","1.75","1850","9655","1100","750","1959","373000"
"4","2.75","2330","14175","1800","530","1980","372000"
"4","1","1590","7085","1590","0","1944","365000"
"2","1","990","9223","990","0","1949","365000"
"2","1.75","1760","4600","850","910","1926","355000"
"3","2.5","1380","1590","1160","220","2012","350000"
"4","1.75","1670","8856","1070","600","1955","349170"
"2","1.75","1010","1461","670","340","2003","340000"
"2","1","1120","5329","750","370","1929","320000"
"5","2","2250","5472","1750","500","1930","319450"
"4","2.5","1780","5822","1780","0","2001","311000"
"2","2","840","14564","840","0","1942","308500"
"4","2.25","1950","7700","1350","600","1979","305000"
"3","1","1600","1950","1600","0","1906","302000"
"3","1","970","12300","970","0","1982","300000"
"3","2.5","2240","3691","2240","0","2003","300000"
"3","1.75","1210","7000","1210","0","1975","300000"
"4","1","1330","8184","1330","0","1949","290000"
"5","2.5","2780","9652","1390","1390","1967","290000"
"3","2.25","1650","10336","1500","150","1962","290000"
"4","2.25","1980","9714","1170","810","1977","286285"
"3","1","1310","22652","1310","0","1968","280000"
"3","1.5","1420","22100","1420","0","1957","269900"
"3","2.25","1560","8280","1560","0","1979","239950"
"3","2.5","1360","5754","1360","0","1994","239000"
"4","1.5","1690","11054","1690","0","1930","235000"
"2","1","1250","8520","1250","0","1928","200000"
"3","1","1340","7260","1340","0","1944","199950"
"3","1.75","1520","7137","1520","0","1932","198500"
"3","1.5","1010","5000","1010","0","1943","194000"
"3","1","1190","8820","1190","0","1959","166950"
"1","1","730","6890","730","0","1926","140000"
"3","1","860","10426","860","0","1954","82000"
"4","3","4280","18834","2180","2100","1971","2050000"
"3","2.75","2620","17919","2620","0","1949","1880000"
"4","4.25","5550","12968","5550","0","2005","1500000"
"4","2.5","2910","7364","2910","0","2003","1430000"
"4","3.5","3530","8126","3530","0","2007","1280000"
"5","2.5","3890","27311","3890","0","1950","1100000"
"4","3.5","3740","41458","3740","0","2000","1080000"
"5","2","2440","3080","2440","0","1910","1010000"
"2","2.5","2720","26761","2720","0","1990","985000"
"4","2.75","2900","17802","1750","1150","1981","926500"
"3","3","2630","10156","2630","0","1987","778000"
"4","2.75","2010","7000","2010","0","1901","774000"
"4","2.5","2470","2550","2470","0","2004","735000"
"3","1.75","1930","5000","1230","700","1936","716500"
"3","1.75","1480","7000","1480","0","1963","685000"
"4","3.5","3040","8414","2420","620","2010","684000"
"4","3.5","2510","3763","1990","520","2013","680000"
"4","2.5","2410","7069","2410","0","1993","635000"
"4","1","1390","3708","1390","0","1926","610000"
"4","2.5","2260","9696","2260","0","1983","608700"
"2","1","1160","5029","910","250","1940","605125"
"4","2.5","2520","35636","2520","0","1980","575000"
"4","1.5","1810","6000","1350","460","1952","560000"
"2","1","1550","4600","1050","500","1941","555000"
"3","2.5","1960","8469","1960","0","1984","552321"
"4","1.75","2550","39460","1890","660","1982","550000"
"2","1.75","1930","5570","1930","0","2005","515000"
"2","1","1640","5200","1040","600","1937","515000"
"3","2.5","2110","208737","2110","0","1977","500000"
"3","1.75","2140","6000","1070","1070","1948","481500"
"4","1.5","1780","8400","1080","700","1969","473600"
"5","2.25","3020","10010","1510","1510","1959","465000"
"4","2.5","2170","7700","1420","750","1969","465000"
"3","2","1430","14250","1430","0","1953","465000"
"3","1.75","1750","7200","1750","0","1966","445000"
"3","2.5","2120","4500","2120","0","2000","437500"
"3","2.5","1920","9812","1920","0","2000","432000"
"2","1","1760","4441","1310","450","1950","428950"
"3","1","1060","7638","1060","0","1966","420000"
"4","2","2280","39848","2280","0","1991","416500"
"2","1","1030","4366","1030","0","1912","410000"
"3","2","1590","10229","1590","0","1966","395000"
"3","3","1490","2944","960","530","1993","390000"
"5","1.75","2290","7900","1190","1100","1965","390000"
"3","2","1640","9750","1640","0","1959","375000"
"3","2","1410","10078","1410","0","1983","375000"
"4","2.5","2689","5724","2689","0","2006","368000"
"4","2.5","2390","7115","2390","0","1999","360000"
"4","2.5","2570","6466","2570","0","1999","355000"
"4","1.75","1780","9794","1780","0","1967","353000"
"3","2.5","1990","20466","1410","580","1987","345000"
"4","2.5","2020","3600","2020","0","2012","345000"
"3","3.25","1210","1173","1000","210","2002","343000"
"4","1.75","1530","8152","910","620","1948","338000"
"4","1.75","1820","14319","1820","0","1969","331500"
"3","1.75","1470","7650","1130","340","1983","328000"
"4","2.75","2150","9163","1340","810","1992","320000"
"1","1","700","3876","700","0","1910","315000"
"2","1.5","1010","10005","1010","0","1981","310000"
"2","2","1500","1408","1500","0","1999","308625"
"2","1","890","5000","890","0","1947","302000"
"3","1","1260","5000","1260","0","1968","300000"
"3","1","1580","5250","1580","0","1954","299950"
"3","1","1160","7875","1160","0","1953","285000"
"4","1","1650","9750","1650","0","1964","282500"
"2","1","880","5750","880","0","1939","280000"
"3","1.75","1400","8364","1400","0","1958","274000"
"3","2.5","1820","6785","1420","400","1994","245000"
"2","1","1470","25661","1470","0","1932","230000"
"2","1","710","6960","710","0","1943","216500"
"3","2","1380","9000","1380","0","1946","215500"
"2","1","1080","9067","1080","0","1951","203000"
"3","1","1120","5200","1120","0","1976","195700"
"3","1.75","1190","14777","1190","0","1965","195000"
"2","1","950","9000","950","0","1924","193000"
"3","1","1280","7572","1280","0","1958","175000"
"2","1","830","4500","830","0","1920","160000"
"3","1","980","6800","980","0","1946","144000"
"6","2.25","4910","6600","3580","1330","1910","1680000"
"4","3.5","4700","10183","2660","2040","2002","1240000"
"4","3.5","4340","217800","4340","0","2003","1190000"
"4","3.5","4270","12305","4270","0","1994","1160000"
"4","2.5","2790","10289","2790","0","1987","982000"
"4","3.25","3720","7150","3720","0","2007","980000"
"3","1","1220","8119","1220","0","1955","875000"
"4","3","3720","14125","1930","1790","1960","875000"
"4","3.5","3460","7702","3460","0","2010","855000"
"4","3.25","3020","13457","3020","0","1956","808100"
"3","3","2900","11769","2900","0","1997","799950"
"3","2.5","2640","432036","2640","0","1996","790000"
"3","2.5","2930","33981","2930","0","2000","785000"
"4","2.5","3270","9578","3270","0","1993","785000"
"3","2","2100","72745","2100","0","1995","740000"
"4","2.5","2570","7980","2570","0","1998","715000"
"4","4","1550","6596","1550","0","1907","707500"
"4","3","2820","2850","1860","960","1928","697000"
"4","2.5","2290","9120","2290","0","1977","660000"
"3","1","1270","3600","1270","0","1906","655000"
"4","2.5","2110","6820","1530","580","1942","650000"
"5","2.25","3340","52476","3340","0","1975","645000"
"4","2.5","3440","6915","3440","0","2006","616000"
"4","2.25","2880","9996","1920","960","1981","614000"
"4","1.75","2720","7810","1510","1210","1952","599950"
"4","2.5","2380","4950","2380","0","2004","590000"
"3","2","2060","7000","2060","0","1988","574000"
"3","2","1810","2738","1810","0","1979","515000"
"3","2.25","2900","35273","2900","0","1986","485000"
"3","2.5","2560","16420","2560","0","1989","470950"
"4","2.5","2590","16437","2590","0","1986","465000"
"5","2.75","2720","193406","1700","1020","1968","456000"
"3","2.5","1990","3478","1520","470","1990","450000"
"3","1.75","1270","6600","1270","0","1903","449000"
"4","3.25","3450","5000","3450","0","2008","445000"
"3","1.5","2710","47419","2170","540","1980","442500"
"2","1.5","1080","6760","1080","0","1923","440000"
"4","2.5","2320","4524","2320","0","2004","429950"
"3","1","1540","37950","1090","450","1959","429000"
"3","2","1420","12655","1420","0","1968","421000"
"4","1.5","2700","3200","2700","0","1940","415000"
"3","1.75","1860","48076","1860","0","1929","407185"
"3","2.5","1470","1779","1160","310","2005","379770"
"3","2.5","1980","6922","1980","0","1991","370000"
"3","2.5","2210","6280","2210","0","2003","359950"
"3","1","1760","3000","1760","0","1900","352950"
"4","2.25","2670","9040","2170","500","1955","339950"
"3","1.75","2390","30409","1560","830","1953","335000"
"4","1.5","2500","9448","1250","1250","1966","330000"
"3","2.5","2000","9669","2000","0","1992","324360"
"4","2.5","2190","7125","2190","0","1978","320000"
"3","1","1520","8870","1520","0","1951","320000"
"3","1.5","720","7450","720","0","1924","295000"
"3","1.75","1390","13200","1390","0","1979","290000"
"3","1.75","1340","63597","1340","0","1963","290000"
"3","2.5","1600","6315","1600","0","2013","287000"
"3","1","1400","10800","1400","0","1962","279900"
"4","2.5","1940","6887","1940","0","1990","278000"
"4","1.5","1610","6923","1010","600","1969","275000"
"3","2","1390","6005","1390","0","2005","267000"
"2","2","1140","8400","1140","0","1954","255000"
"3","1.75","1330","9831","1330","0","1987","248000"
"3","1","1010","9678","1010","0","1955","245000"
"2","1","670","2356","670","0","1960","245000"
"3","1.75","1770","8571","1270","500","1978","240000"
"3","1","1360","9310","1020","340","1980","230000"
"3","1","1280","7198","1280","0","1916","227000"
"3","1.75","1300","7735","1300","0","1980","224500"
"2","1","720","4760","720","0","1942","217000"
"3","1.75","1510","8400","980","530","1979","195000"
"2","1","1280","7861","1280","0","1913","195000"
"3","1.5","1010","5000","1010","0","1953","185000"
"3","1","960","10125","960","0","1952","179950"
"2","1","760","5240","760","0","1949","129000"
"5","3.75","3530","13260","3530","0","2013","1610000"
"3","1.75","1160","6120","1040","120","1941","450000"
"3","1.5","1310","2998","1310","0","1998","325000"
"4","2.25","1870","4198","1870","0","2008","313999"
"3","2.5","2242","5744","2242","0","2012","310000"
"3","2.5","2470","9226","2470","0","1991","607000"
"3","2.5","2990","6771","1550","1440","2003","373000"
"3","1.75","1590","9636","1590","0","1953","346000"
"3","3.25","2610","16387","2610","0","2006","2000000"
"5","4.5","6070","5432","6070","0","2004","1570000"
"5","3.75","3290","6480","2190","1100","1938","1390000"
"3","3","3230","8625","2220","1010","1998","1260000"
"3","2.5","3670","18505","2530","1140","1983","1250000"
"3","2.5","2660","1973","1870","790","2007","1240000"
"4","2.5","3940","4407","2620","1320","1921","1200000"
"4","3.75","3180","9889","2500","680","2012","1150000"
"4","2.75","2580","8100","1780","800","1964","1080000"
"3","2.5","3545","9816","2610","935","2005","1030000"
"4","1","1820","5400","1820","0","1923","1010000"
"4","3","3060","50002","2460","600","1957","959750"
"2","1.75","1490","9874","1490","0","1963","898000"
"4","2.25","2180","11056","1370","810","1963","830000"
"2","1","1210","8400","780","430","2000","824000"
"4","2.5","3040","35201","3040","0","1987","725000"
"3","2.75","2440","76531","1640","800","1980","720000"
"3","2","1720","4200","1720","0","1908","713500"
"3","1.75","2100","5000","2100","0","1916","700000"
"3","2","1940","4500","1090","850","1926","700000"
"3","1","1210","3720","1210","0","1930","640000"
"2","1","1110","3500","970","140","1912","600000"
"4","3.5","4300","70407","2710","1590","1992","600000"
"5","2.5","2640","4400","1840","800","1925","593000"
"3","2.5","2320","3980","2320","0","2003","580500"
"4","2.5","2040","5508","2040","0","1996","575000"
"4","1.5","1370","3708","1370","0","1926","545000"
"3","1","1090","3000","1090","0","1929","535000"
"3","1","1440","8681","1440","0","1937","523000"
"3","1.75","1730","18250","1730","0","1988","521000"
"3","2.5","2280","58712","2280","0","1987","520000"
"3","1.75","1430","53628","1430","0","1985","520000"
"5","1.5","1550","9750","1550","0","1966","510000"
"4","2","1360","2746","1360","0","1945","507000"
"4","2.5","1950","3000","1550","400","1998","497950"
"5","1.5","1420","9900","1050","370","1964","485000"
"4","2","2410","4680","2410","0","1974","470000"
"3","2","1820","1357","1820","0","2014","469950"
"2","1.75","1250","7029","1250","0","1986","468000"
"3","2.5","1690","6642","1690","0","2004","467000"
"3","2.25","1520","14080","1520","0","1984","447000"
"3","2.5","1650","4929","1520","130","2007","440000"
"2","1.75","1620","113862","1620","0","1995","439000"
"2","2","1600","5643","1600","0","1954","438200"
"4","2.5","2640","3899","2640","0","2000","436000"
"5","2.5","2180","7875","1200","980","1955","425000"
"3","1.75","1610","144619","1610","0","1977","425000"
"2","1","980","4108","980","0","1947","415000"
"3","1","1130","4100","990","140","1941","400000"
"3","2.5","2770","8820","1900","870","1980","390000"
"3","3.5","1370","1540","1100","270","2006","385000"
"4","1.75","2120","7680","1060","1060","1950","379400"
"3","1","1290","8974","1290","0","1976","373000"
"2","1","780","1133","780","0","2009","370000"
"4","2.75","2760","4050","1400","1360","1997","369950"
"3","1.75","1120","9730","1120","0","1944","362000"
"2","1","850","5225","850","0","1949","354000"
"3","1","940","7811","940","0","1959","350000"
"4","2.5","2506","7206","2506","0","2007","350000"
"3","2","970","10000","970","0","1972","339300"
"3","1.75","1610","22496","1610","0","1974","338950"
"3","1.75","1250","7710","1250","0","1947","338000"
"3","1","1070","10563","1070","0","1969","330000"
"4","2.5","1780","6000","1780","0","2000","315000"
"5","1.75","2110","8500","1100","1010","1962","300000"
"3","2.5","1420","3542","1310","110","2007","290000"
"4","2.5","1785","2552","1785","0","2009","282000"
"4","2.25","1990","7350","1180","810","1978","280000"
"3","2.5","2010","11618","2010","0","1990","279000"
"2","1.5","1240","1055","1200","40","1967","277700"
"3","1.5","1580","14040","1050","530","1980","264500"
"2","1.5","1160","5000","890","270","2006","250000"
"3","2.5","1620","5250","1620","0","1987","240000"
"3","1","1240","239144","1240","0","1921","234000"
"3","1","980","12812","980","0","1956","218000"
"3","1","1040","8125","1040","0","1956","210000"
"3","1.5","1210","7247","1210","0","1967","208000"
"3","2","1230","8235","1230","0","1959","195000"
"2","1.75","1020","10346","1020","0","1983","187000"
"2","1","800","8125","800","0","1964","145000"
"2","1","760","3800","760","0","1950","135900"
"4","2.5","3440","23954","2260","1180","1931","2490000"
"3","3.25","3440","4080","2560","880","2005","1320000"
"5","1.75","1910","5640","1910","0","1906","1130000"
"5","3.25","4010","12110","4010","0","2003","1100000"
"4","3.5","3500","43560","2850","650","2014","998000"
"4","1.75","4060","4000","2890","1170","1953","970000"
"4","2.5","3510","28052","3510","0","1988","915000"
"5","3.5","3700","5400","2890","810","2011","830000"
"3","2.5","3280","26413","2670","610","1985","825000"
"4","2.25","2510","11585","2510","0","1969","799000"
"4","2.5","3340","123600","3340","0","2005","749950"
"5","3.25","2400","3118","1780","620","1928","700000"
"3","3","2980","3730","2980","0","2005","670000"
"5","2.5","3220","4759","3220","0","2003","640000"
"5","3","3520","36558","2100","1420","1985","632000"
"3","2.25","2490","8800","2490","0","1975","590000"
"3","1.5","1560","20251","1200","360","1989","577000"
"4","3.25","3230","4838","3230","0","2014","572115"
"4","2.5","3370","4934","3370","0","2014","559630"
"3","2","1670","11337","1670","0","1959","555565"
"4","1.75","1740","4816","870","870","1942","554950"
"4","2","2100","4500","1060","1040","1924","550000"
"5","3.5","2440","10200","2440","0","1974","519950"
"2","1.5","1400","5000","1150","250","1904","515000"
"4","3.5","2710","14016","2710","0","1968","502700"
"4","2.5","2200","3141","2060","140","1994","465000"
"3","1.75","1430","11761","1430","0","1964","462600"
"3","1.75","1690","6375","1690","0","1903","457000"
"4","2.5","2716","7850","2716","0","2014","452000"
"3","1.75","1350","7200","1350","0","1954","450000"
"4","2.5","2680","4670","2680","0","1998","437500"
"4","2.75","1820","5400","1220","600","1988","430000"
"4","2","1970","6480","1130","840","1920","423000"
"3","2.5","3087","5002","3087","0","2014","399950"
"3","1.75","1170","8148","1170","0","1952","399000"
"2","2","1120","1468","760","360","2004","380000"
"4","3","2580","5511","2580","0","1999","370000"
"3","2.5","2310","7485","2310","0","1986","362000"
"3","2.5","1300","812","880","420","2008","329950"
"2","1","840","5087","840","0","1925","315000"
"3","2.25","2130","8800","1270","860","1978","283000"
"3","2.5","1480","7200","1480","0","1995","256000"
"3","2.5","1680","8284","1680","0","1989","252000"
"3","2.5","1790","6191","1790","0","1992","250000"
"3","1.75","1380","7500","1380","0","1988","240000"
"4","2.25","1950","7280","1950","0","1979","220000"
"3","1.75","1290","8250","1290","0","1983","220000"
"2","1.75","1320","13052","1320","0","1980","200000"
"3","1","1100","6000","1100","0","1926","174900"
"3","1","1010","7690","1010","0","1958","165000"
"4","3.5","3600","5217","2720","880","1947","1350000"
"4","2.5","3480","12164","3480","0","1984","1190000"
"5","3.25","4290","7019","3590","700","1927","1160000"
"4","3.25","4740","49091","4740","0","1990","1150000"
"4","2.25","3240","12930","2730","510","1968","1070000"
"2","2.5","2350","2390","2000","350","2007","1050000"
"4","3.25","3610","4000","2640","970","2007","1010000"
"4","2.25","3010","9800","3010","0","1973","980000"
"4","3.5","4030","4200","4030","0","1992","950000"
"4","1.75","1920","3600","1920","0","1907","870000"
"4","2.5","3960","38615","3960","0","2000","805000"
"4","2.5","2560","12760","1760","800","1949","790000"
"4","2.5","3140","16200","2570","570","1988","765000"
"7","2.75","3410","4056","2130","1280","1906","750000"
"4","2.75","2310","10232","1310","1000","1980","750000"
"4","2.5","3130","10860","3130","0","1990","745000"
"3","2.5","2470","10321","2470","0","1988","732500"
"4","3","2910","8540","2910","0","2003","701000"
"3","2.5","1910","5125","1910","0","2006","663000"
"3","2.5","3090","384634","3090","0","2007","659000"
"2","2.5","1680","1240","1120","560","2014","653500"
"4","2","2208","5000","2208","0","1917","650000"
"3","2.5","2870","7288","2870","0","2012","650000"
"4","2.5","2990","8622","2990","0","2000","645500"
"4","3","2940","5763","1640","1300","1955","640000"
"4","1.75","2350","18800","2350","0","1959","620000"
"5","3","2600","13674","1300","1300","1967","599950"
"4","2.5","3030","6813","3030","0","1987","557865"
"3","1.75","1840","9401","1840","0","1971","550000"
"5","1","1500","3978","1500","0","1929","549000"
"4","2.5","3010","9000","3010","0","2008","530000"
"4","2.75","2440","5080","1750","690","1960","525000"
"2","2.5","1830","2856","1830","0","2005","524950"
"4","2.5","3390","7870","3390","0","2014","495000"
"3","2.25","1790","11393","1790","0","1978","493000"
"6","1.75","2120","3801","1220","900","1925","493000"
"3","2.25","1500","1290","1220","280","2006","490000"
"3","1.75","1900","43700","1900","0","1919","476800"
"3","1.75","2270","13000","2270","0","1968","475000"
"3","2","1570","6300","820","750","1953","468000"
"3","2.25","2560","117176","1280","1280","1977","465000"
"3","3.25","1510","1850","1230","280","2001","465000"
"4","2.5","2080","17532","2080","0","1996","460000"
"4","3","2800","7845","2800","0","2002","457000"
"3","2","2320","17688","2320","0","1952","450000"
"3","2","1880","3048","1880","0","1902","449950"
"5","3","2420","11250","2420","0","2013","445000"
"2","1","1070","6625","830","240","1950","425000"
"2","1.75","1550","4257","830","720","1953","415000"
"5","2.5","3370","5092","3370","0","2006","405000"
"3","1.75","1480","1448","870","610","1926","402300"
"2","1","790","4000","790","0","1948","399000"
"3","1","990","4250","840","150","1924","399000"
"3","1","1710","5110","1100","610","1954","396500"
"2","1.5","1010","3060","1010","0","1918","395000"
"3","2","1470","10125","1470","0","1962","395000"
"4","2","2195","2681","1060","1135","1912","392450"
"3","1","1110","7128","1110","0","1980","379500"
"3","2.25","1470","9140","1470","0","1982","376000"
"2","1.5","1160","8060","1160","0","1950","365000"
"5","2.5","2880","8216","2880","0","2001","362000"
"3","1","1000","4080","740","260","1945","357500"
"3","1","980","7000","980","0","1953","330000"
"2","1","940","7700","940","0","1916","329000"
"4","2.5","2770","19116","1600","1170","1961","318700"
"2","1","1100","4010","1100","0","1920","300000"
"3","2.5","1940","14952","1940","0","1994","297000"
"4","2.5","2423","7292","2423","0","2005","290000"
"3","1","1700","8645","1700","0","1955","284700"
"3","1","1340","21336","1340","0","1945","281000"
"3","1","1320","11090","1320","0","1955","275000"
"4","2.5","1790","4358","1790","0","1993","260000"
"3","1.5","1240","9500","1240","0","1955","259950"
"3","2","1340","5670","1340","0","1994","252000"
"4","2","1870","8750","1870","0","1977","245000"
"3","1.5","1660","8738","1080","580","1959","235000"
"2","1","1200","9488","1200","0","1941","231500"
"3","1","1660","21514","1660","0","1973","220000"
"2","1","1090","9994","1090","0","1954","196700"
"3","1","920","4875","920","0","1969","179950"
"3","1","1300","6098","1300","0","2013","155000"
"2","1","710","9900","710","0","1943","129888"
"5","4","5190","14600","5190","0","2013","2900000"
"3","2.25","3370","23065","1920","1450","1980","1600000"
"4","4.5","3130","5126","2450","680","2014","1330000"
"3","3.25","3400","5979","2290","1110","1937","1300000"
"4","2.75","4110","8400","3130","980","1928","1200000"
"5","2.25","4320","7620","2880","1440","1973","1100000"
"2","2.5","1680","975","1680","0","2009","840000"
"3","1","1510","4178","1510","0","1902","799000"
"4","2.75","3820","26300","2850","970","2014","770000"
"4","2.5","3360","13636","3360","0","1987","765000"
"4","2.5","2850","11000","2850","0","1998","760000"
"2","2.25","1630","1686","1330","300","2014","729999"
"5","2.5","3780","9870","1890","1890","1978","725000"
"2","1","1580","2199","1580","0","1921","720000"
"4","2.25","2550","12918","2550","0","1987","703770"
"4","2.5","2580","15031","2580","0","1999","700000"
"3","2.25","1710","1193","1140","570","2014","685000"
"4","1.75","2250","4750","1420","830","1924","637800"
"4","2.5","2100","8800","1240","860","1960","630000"
"2","2","990","5416","990","0","1935","600000"
"3","1.75","2060","3600","1180","880","1905","595000"
"3","2.5","2150","7484","2150","0","1988","580000"
"3","2.5","1910","11550","1910","0","2003","580000"
"3","2.25","1860","4000","1020","840","1920","572000"
"3","2","1390","2688","1390","0","1915","550000"
"3","2.5","2380","2500","2380","0","1988","549950"
"3","2.5","1990","5149","1990","0","2003","545000"
"3","1.75","1530","6125","1120","410","1958","526000"
"5","1","1590","5000","1190","400","1929","518000"
"4","2.5","2070","10244","1370","700","1969","518000"
"2","1","1390","5544","930","460","1947","510000"
"3","1.75","1370","6700","1370","0","1940","510000"
"5","3.75","3880","8370","3880","0","2004","506000"
"4","2.5","2250","14440","1550","700","1967","496500"
"3","1.75","1660","8208","1660","0","1965","490000"
"3","2.25","1840","8400","1290","550","1961","472800"
"4","1.75","1450","3750","950","500","1925","471000"
"3","1.75","2760","9137","1380","1380","1960","465000"
"3","2.5","2090","8653","2090","0","1989","455000"
"2","1.75","1510","6852","1510","0","2005","449000"
"4","2.5","3080","10646","3080","0","1993","440000"
"3","2.5","1800","3265","1800","0","2014","437718"
"3","2.5","3380","7074","2200","1180","1999","435000"
"3","2.5","2030","7770","2030","0","2003","430000"
"2","1","790","5024","790","0","1941","425000"
"3","2.5","1280","5040","1280","0","1985","415000"
"3","2.5","2420","10733","2420","0","1996","415000"
"2","1.5","1210","1278","1020","190","2007","414500"
"4","1","1140","7208","900","240","1970","410000"
"3","3.5","1522","1465","1248","274","2006","407500"
"3","1.5","1510","8360","1120","390","1960","400000"
"6","2","2320","210830","2320","0","1962","400000"
"2","2.5","1340","1240","1150","190","2008","400000"
"4","1.75","2120","7620","2120","0","1971","397950"
"3","1","950","3621","950","0","1947","390000"
"4","2.75","2390","9650","1620","770","1976","379750"
"3","1.5","1000","6914","1000","0","1947","378000"
"3","1.5","1320","7201","1320","0","1971","370000"
"2","1.5","893","965","893","0","2007","359950"
"3","1.5","1140","7500","1140","0","1976","356000"
"2","1","940","5000","940","0","1950","350000"
"4","1.5","1420","6720","1420","0","1925","349950"
"3","1.5","1130","7223","1130","0","1961","341500"
"3","2.5","1240","1115","1240","0","2003","340000"
"4","1","1200","11834","1200","0","1972","340000"
"2","1","790","6000","790","0","1948","325000"
"6","2.75","2410","10763","1310","1100","1957","320000"
"2","1","2080","14659","1040","1040","1960","315000"
"5","2.75","2210","13500","1460","750","1963","314000"
"3","2.5","1260","11877","1260","0","1975","312620"
"2","1.5","1040","83199","870","170","1965","310000"
"4","3","2320","7200","2320","0","1976","310000"
"3","2.25","1990","1716","1990","0","1967","309950"
"4","2","2470","1831","1970","500","2009","305000"
"4","1.75","2251","12731","1390","861","1957","305000"
"4","2.25","1763","3717","1763","0","2012","305000"
"2","1","860","7204","860","0","1918","284000"
"3","2","1450","8928","1450","0","1998","276000"
"3","1.5","1510","16200","1510","0","1970","275000"
"2","1","680","4190","680","0","1906","275000"
"2","1","1040","5700","1040","0","1922","270000"
"2","1.5","980","1296","840","140","2001","260000"
"3","2","1810","10684","1810","0","1987","252500"
"4","1","1440","7404","1080","360","1918","250000"
"4","1.5","1220","4900","1220","0","1942","250000"
"3","2","1270","7198","1270","0","1916","247000"
"2","1.5","1450","6258","1450","0","1983","245000"
"2","2","1470","2052","1470","0","1986","239000"
"2","1","1190","11400","1190","0","1951","238950"
"3","1.5","1120","11430","1120","0","1963","227950"
"3","1","1840","10178","1040","800","1960","210500"
"3","1.75","1260","6223","820","440","1983","210000"
"3","1","1200","7500","1200","0","1905","210000"
"3","1","1330","9620","1330","0","1976","206990"
"3","1","1130","7014","1130","0","1954","205000"
"1","0.75","680","9600","680","0","1947","200000"
"3","1","940","11055","940","0","1959","180000"
"3","1.75","1150","8690","1150","0","1977","166600"
"2","1","770","8150","770","0","1951","163250"
"2","1","980","5393","980","0","1969","128000"
"4","4.25","5770","21300","5770","0","1980","3850000"
"4","2.25","4760","8036","3390","1370","1916","2250000"
"4","4.5","5770","10050","3160","2610","1949","1540000"
"4","2.75","2950","4560","1810","1140","1912","1050000"
"3","3.5","2880","11340","1690","1190","1980","1020000"
"5","3.5","5470","35071","4590","880","1976","975000"
"3","1.5","2140","3600","1900","240","1925","940000"
"4","2.5","3520","35991","3520","0","1992","864500"
"5","2.75","2790","20824","1680","1110","1959","840000"
"4","2.25","2020","5600","1210","810","1961","810000"
"5","4.5","4600","7810","3200","1400","2006","805000"
"4","3","3180","12070","3180","0","1976","790000"
"3","2.5","1580","991","1580","0","2009","727000"
"3","2","1660","3600","1000","660","1939","635500"
"3","3.25","3800","13995","3800","0","1983","630000"
"5","2.75","2910","13332","2910","0","1940","605000"
"3","2.5","2030","5100","2030","0","2008","595000"
"3","2.5","2280","10879","2280","0","1984","577500"
"3","2.5","1870","3485","1870","0","2001","575000"
"4","2.5","3240","22795","3240","0","1998","574000"
"2","2.5","1950","2457","1950","0","2009","565000"
"3","2.5","2010","17362","2010","0","1994","551000"
"4","3","3160","10948","1930","1230","1991","545000"
"4","2.5","2590","7891","2590","0","2006","530000"
"4","1.75","2520","7770","1680","840","1965","525300"
"4","2.5","3180","20870","2120","1060","1967","523000"
"3","2.5","1810","4332","1810","0","1992","517500"
"3","1","1100","5400","1100","0","1908","505000"
"3","1","1260","9638","1260","0","1920","490000"
"5","2.75","2990","7200","2990","0","1997","490000"
"4","2.25","2500","10890","1800","700","1978","488000"
"4","1.75","1720","3050","1040","680","1929","460000"
"2","1","880","3300","880","0","1909","460000"
"3","1.75","1300","9600","1300","0","1969","455000"
"3","2","1700","10000","1700","0","1992","454000"
"4","2.5","2880","7386","2880","0","1987","440000"
"5","2.5","1710","7700","1710","0","1962","431650"
"4","2.5","3000","9460","3000","0","2001","430000"
"3","2","2350","12480","1600","750","1981","430000"
"3","1.75","1340","13241","1340","0","1985","427800"
"2","1","1670","6212","1670","0","1947","425000"
"6","2","1870","6969","1870","0","1968","380000"
"5","2.5","2250","10400","1280","970","1973","370000"
"4","2","2200","3060","1100","1100","1908","358000"
"5","2.5","2460","5604","2460","0","2011","358000"
"2","1","810","3880","810","0","1952","357950"
"5","2","1890","6050","1890","0","1944","339950"
"3","2.25","1936","9495","1936","0","2013","338900"
"3","2.5","1090","1139","960","130","2009","335000"
"5","1.75","2190","27260","2190","0","1947","310000"
"3","1.5","1140","3292","1140","0","1988","310000"
"4","2.5","1920","7345","1920","0","1992","303500"
"2","1.5","830","1276","830","0","2005","299000"
"4","2.5","1720","5805","1720","0","2000","295700"
"3","1","1080","8214","1080","0","1944","284000"
"3","2","1640","13249","1640","0","1995","280000"
"3","2.5","1680","8512","1680","0","1991","272000"
"3","2.25","1610","7187","1610","0","1988","269950"
"3","1","1860","9225","1860","0","1957","265500"
"3","2.5","1520","6298","1520","0","1986","260000"
"3","2.5","1780","7192","1250","530","1974","252500"
"1","1","460","4120","460","0","1937","247000"
"2","1","960","8450","960","0","1950","244000"
"3","1.75","1560","10919","1560","0","1975","236000"
"3","1","940","7980","940","0","1961","223000"
"1","1","720","7140","720","0","1930","199900"
"3","1.5","1090","9605","1090","0","1969","185000"
"3","1","1010","8581","1010","0","1920","180000"
"2","1.75","590","6138","590","0","1947","156000"
"5","4","2980","4500","2070","910","1921","842500"
"4","1.75","2340","9100","1610","730","1975","700000"
"4","2.5","2500","5264","2500","0","2003","336500"
"6","3","2580","8064","1880","700","1913","326000"
"4","1.75","2160","28750","2160","0","1978","324888"
"3","3","2610","22672","2610","0","1952","1580000"
"4","5.25","6110","10369","6110","0","2005","1320000"
"4","3.75","3490","5625","2610","880","2014","1310000"
"4","3.75","3980","7828","3980","0","2001","925900"
"4","2.75","2560","7961","1450","1110","1975","880000"
"3","1.75","2180","14135","1300","880","1947","860000"
"4","2.75","2760","5670","2760","0","2014","847093"
"3","2.5","2690","17461","2690","0","1997","805000"
"4","1.75","2150","9148","2150","0","1955","800000"
"5","3.5","3330","3705","2610","720","2008","795000"
"4","2.75","3420","6787","3420","0","2010","780000"
"4","2.5","3220","38448","3220","0","1993","775000"
"4","2.75","2560","6900","1480","1080","1959","740000"
"4","3.25","3910","6293","3130","780","2006","709950"
"3","1.75","1760","4125","1760","0","1927","688500"
"3","2","2310","10525","2310","0","1965","627000"
"3","2.5","2830","5831","2830","0","2010","614000"
"6","3","2600","9350","1340","1260","1963","600000"
"4","2.25","1970","5562","1500","470","1908","600000"
"4","2.75","2870","7200","2870","0","2008","577288"
"3","2.5","2510","5186","2510","0","2001","571000"
"4","1.75","2630","11213","1430","1200","1948","567000"
"5","2.5","3440","12900","1720","1720","1958","554000"
"4","2.5","2820","25995","2820","0","1998","545000"
"4","2.75","2650","6717","2650","0","2014","545000"
"3","1.75","1610","3478","1060","550","1929","540000"
"3","1","2000","22500","1680","320","1939","525000"
"3","2.5","2180","1850","2180","0","2010","496000"
"3","1.75","2090","7667","1200","890","1952","489000"
"4","2.5","2714","12558","2714","0","2014","485230"
"5","2","2040","6180","2040","0","1908","475000"
"5","3.5","3430","6872","2830","600","2002","473000"
"4","1.75","1920","6000","960","960","1954","455000"
"3","1.75","1430","20193","1430","0","1955","453000"
"2","1.5","1160","1269","970","190","2005","453000"
"4","1","1460","4600","780","680","1946","445000"
"3","1.75","1810","7950","1810","0","1968","443000"
"4","2.5","2350","7203","2350","0","1989","440000"
"5","1","2170","65340","1670","500","1930","435000"
"3","1","1200","5252","1200","0","1962","427000"
"2","1","1630","7680","830","800","1947","426000"
"3","2.5","2000","4500","2000","0","2010","417000"
"4","2","1900","5100","950","950","1914","410000"
"3","1","1340","4120","1040","300","1921","409500"
"2","1.5","1240","1101","1080","160","2009","403000"
"4","3","2240","7035","2240","0","1942","400000"
"2","1","1000","7664","1000","0","1939","397000"
"3","1.5","1300","8280","1300","0","1956","396000"
"4","2","2240","7085","2240","0","1944","395000"
"4","2","1830","21183","1060","770","1966","383000"
"3","1","1040","9800","1040","0","1955","375000"
"3","1.75","2120","11340","1060","1060","1966","368000"
"3","1","1370","6450","1370","0","1948","357000"
"2","1","670","7312","670","0","1942","348000"
"4","2.25","2180","7000","1680","500","1969","318000"
"3","1.5","1550","7260","1550","0","1925","313000"
"3","2.75","1400","7880","1000","400","1981","311000"
"3","1.75","1140","8263","1140","0","1950","310000"
"3","2.25","3100","11985","1790","1310","1963","302500"
"4","2.5","2830","7350","1690","1140","1982","295500"
"4","2","1810","42981","1810","0","1973","295000"
"4","2.5","1810","4871","1810","0","1999","295000"
"4","2","1390","745","1390","0","2008","288790"
"1","1","1060","54846","1060","0","1935","285000"
"4","2.5","1613","4338","1613","0","2009","279500"
"2","1","820","6200","820","0","1954","274000"
"4","2.5","1870","5692","1870","0","2004","272000"
"3","1.5","1950","7560","1320","630","1975","269950"
"4","1.75","1420","7500","1080","340","1981","268500"
"3","2.75","1120","881","1120","0","1999","265000"
"3","2.25","1370","7087","1370","0","1993","264500"
"2","1","700","8100","700","0","1949","254950"
"3","1.5","1090","5000","1090","0","1966","249950"
"2","1","1210","9375","1210","0","1952","239000"
"2","1.5","680","772","680","0","2005","239000"
"2","1","1370","11584","1370","0","1950","237600"
"3","2","1510","9153","1510","0","1974","234950"
"3","1.5","1500","11616","1100","400","1980","230000"
"3","2.5","1340","3011","1340","0","1995","230000"
"3","2.5","1590","8449","1590","0","1989","225000"
"3","1","1000","6020","1000","0","1944","220000"
"3","1.5","1600","10548","1600","0","1962","220000"
"3","1","980","9135","980","0","1955","185000"
"3","3.25","5020","12431","3420","1600","1941","3600000"
"5","4.5","5220","67319","5220","0","2001","1570000"
"3","1.25","2400","6653","2400","0","1992","1390000"
"5","3.25","4115","7910","4115","0","2014","988830"
"3","2.5","2930","9280","2930","0","1988","905000"
"4","2.25","2380","4876","2240","140","1948","875000"
"3","1.5","1530","10827","1530","0","1955","865000"
"4","2.25","2330","10451","2330","0","1965","850000"
"4","2.75","2990","6626","2990","0","2014","814950"
"3","2","2390","9800","2390","0","1921","810000"
"5","1","1750","3861","1750","0","1903","774900"
"3","2.25","1870","1900","1870","0","2008","770000"
"4","2.5","2660","8469","2660","0","1994","751305"
"3","2.5","3380","9528","3380","0","1994","751000"
"3","2.25","2190","2416","2190","0","2014","719950"
"4","2.5","2370","10513","2370","0","1987","688100"
"4","2","2850","4497","1730","1120","1910","650000"
"4","2.5","2390","9638","2390","0","1988","645500"
"6","5.25","3600","3960","2400","1200","1971","643500"
"4","2.5","2180","4000","1700","480","2002","607010"
"4","2.5","2350","7245","2350","0","1993","598850"
"3","1","1320","5000","1090","230","1920","594000"
"3","1.5","1390","5040","1090","300","1947","589000"
"3","3.25","1490","857","1220","270","2001","580000"
"5","2.75","2730","5820","2730","0","2014","565997"
"5","3.25","2860","20790","1800","1060","1965","565000"
"3","1.75","2000","6130","1120","880","1951","549000"
"3","1.75","1680","4240","1680","0","1926","540000"
"5","2.5","3370","4850","3370","0","2007","540000"
"2","1.5","1260","6660","1260","0","1926","531000"
"4","2.25","2240","8376","1740","500","1984","530000"
"5","3.25","3960","321908","2690","1270","1989","525000"
"4","2.5","2890","7306","2890","0","2006","515000"
"3","2.5","2540","40106","2540","0","1991","510000"
"5","2","2740","3838","1370","1370","1959","510000"
"2","2.5","1590","1485","1300","290","1994","509500"
"2","1","1250","5040","950","300","1920","505000"
"4","2.25","2020","4960","1710","310","1938","490000"
"3","2.5","2360","9005","1340","1020","1929","480000"
"2","2.5","1620","14467","1620","0","1981","475000"
"4","2.25","1970","7532","1390","580","1983","475000"
"2","2","1540","7290","1540","0","1948","462500"
"3","2","1690","16061","1690","0","1984","459800"
"3","1.75","2820","8879","1540","1280","1920","456700"
"2","1","1180","6000","1180","0","1910","450000"
"4","2","1700","21780","1080","620","1940","445000"
"3","1.75","1810","7300","1240","570","1976","430000"
"4","2.25","2660","11200","2660","0","1972","425000"
"4","2.5","2550","8824","2550","0","1990","422500"
"3","2.5","1800","5372","1800","0","1987","416000"
"3","2.5","1430","1250","1430","0","2007","399000"
"3","1.75","1290","7205","1290","0","1971","365000"
"3","2.5","1630","11592","1630","0","1987","360400"
"3","2.5","1980","7800","1980","0","1999","359950"
"2","1","1250","4558","1250","0","1948","355000"
"3","2.5","2090","3002","1670","420","2005","352000"
"3","1.5","1030","6969","1030","0","1921","345000"
"3","1.5","1280","5525","1280","0","1962","342450"
"4","2.5","2840","8746","2840","0","2001","339000"
"5","1.75","1240","8936","1240","0","1954","333000"
"3","1.5","1240","1221","1050","190","2009","320000"
"3","1","1340","5175","940","400","1987","320000"
"3","2","1660","11135","1660","0","1971","315000"
"4","2.25","1960","12243","1960","0","1989","308000"
"3","2","1790","7259","1390","400","1980","307000"
"3","1","950","4760","950","0","1929","300000"
"3","2.5","1570","2577","1570","0","2005","299950"
"2","2.5","1400","1262","1160","240","2008","299000"
"3","1","1020","7650","1020","0","1940","293000"
"3","1","1520","8055","1520","0","1952","279000"
"3","2.5","2620","4558","2620","0","2010","277500"
"3","1","1370","17859","1150","220","1930","275000"
"3","1.75","1600","7711","1600","0","1999","268000"
"3","2.5","1810","4113","1810","0","2004","266490"
"4","1.75","960","8863","580","380","1949","255000"
"2","1","620","4760","620","0","1941","255000"
"4","1.75","1940","13370","1940","0","1974","252000"
"3","3","2300","7701","2300","0","1960","250000"
"3","1","1100","7470","1100","0","1917","250000"
"3","2","1470","12096","1470","0","1942","250000"
"3","1.5","1390","12500","1390","0","1976","225000"
"3","1","1080","5000","1080","0","1953","219000"
"4","2.25","1500","5393","1500","0","1999","210000"
"3","1.5","1400","9600","1400","0","1964","210000"
"3","1.5","990","8925","990","0","1962","158000"
"1","1","870","26326","870","0","1939","157000"
"2","1","830","7609","830","0","1943","135000"
"4","3.75","4090","24825","3400","690","1926","2400000"
"4","2.5","3220","20251","3220","0","1969","2380000"
"3","3","3490","4500","3170","320","1924","1050000"
"4","3.5","3350","3752","2550","800","2007","1010000"
"3","2.75","2830","505166","1830","1000","1962","999000"
"3","2.5","2010","6857","1450","560","1955","960000"
"2","1","1240","5500","1240","0","1954","900000"
"4","2.5","3420","7462","3420","0","2002","839900"
"4","2.5","2680","8778","2680","0","1977","788000"
"3","1","2230","3200","1630","600","1918","770000"
"3","2.5","2710","18480","2000","710","1978","740000"
"3","1.75","2280","3446","2280","0","1949","718000"
"4","1.75","2000","6000","1000","1000","1956","710000"
"4","2","1820","5001","1820","0","1947","705000"
"3","2.5","2350","4975","2350","0","2012","700000"
"3","2","1770","1800","1770","0","1999","690000"
"3","1.75","2130","20423","2130","0","1953","667500"
"4","2","1980","23625","1980","0","1938","659000"
"1","2.25","1220","2100","1220","0","1946","611900"
"4","2.5","2080","5562","2080","0","2001","601000"
"4","2.5","2100","3125","1400","700","1907","595000"
"4","2.5","2630","6100","2630","0","2004","576925"
"3","2.25","2180","9246","2180","0","1984","570000"
"3","1.75","1880","45738","1410","470","1980","550000"
"3","2.5","1920","1649","1600","320","2004","542500"
"3","2.5","2030","10958","2030","0","1983","530000"
"2","1","1260","5100","1120","140","1925","528000"
"4","1.5","1430","6380","1130","300","1945","525000"
"5","1.75","2040","5280","1020","1020","1961","520000"
"3","3","2390","1210","2390","0","2008","519500"
"3","1","1190","7000","1190","0","1943","517500"
"3","2.5","2430","4203","2430","0","2001","515000"
"3","1.75","1810","5733","1010","800","1926","515000"
"4","1.5","1800","6750","1800","0","1950","508500"
"3","2.5","2100","9040","1700","400","1989","506400"
"5","1","1810","11205","1810","0","1915","495000"
"4","2.5","2300","7314","1420","880","1979","465000"
"2","1.5","1820","7800","1240","580","1956","460000"
"3","2.5","1440","5434","1440","0","2003","440000"
"3","1","1180","3750","1030","150","1940","425000"
"4","1.75","1980","8400","1330","650","1968","425000"
"3","1","1630","8146","1630","0","1952","415000"
"3","1.75","1640","6435","1190","450","1972","415000"
"3","1.5","1090","8400","1090","0","1966","415000"
"2","1","920","4400","920","0","1948","412133"
"3","1.75","1640","11730","1640","0","1967","397000"
"3","1.75","1540","8925","1540","0","1957","392500"
"3","2","1450","9132","1450","0","1987","391500"
"2","1.5","1070","877","1070","0","2005","382000"
"2","2.5","1700","2513","1700","0","2009","378000"
"3","2.5","1930","6180","1330","600","1961","375000"
"3","2.5","1600","2042","1600","0","2005","375000"
"4","2.5","2030","4499","2030","0","2003","365500"
"3","2.5","1810","3192","1070","740","2001","355000"
"4","2.5","2650","6366","2650","0","1998","352000"
"3","2.25","2580","7434","1630","950","1963","340000"
"3","1.5","1260","5758","1260","0","1999","333000"
"4","2.5","2280","9899","2280","0","1987","325000"
"3","1.5","1700","8067","1250","450","1956","315000"
"3","1.75","1610","7350","1610","0","1974","313500"
"3","2.5","2280","6386","2280","0","2008","312000"
"3","2.5","1850","4600","1850","0","2005","299000"
"3","1.5","2060","15050","2060","0","1938","294000"
"1","2","1240","4800","1240","0","1910","290000"
"1","1","550","5700","550","0","1916","290000"
"3","1","1470","8200","1040","430","1953","290000"
"2","1.5","1010","6000","1010","0","1923","269000"
"4","2.75","1500","7036","1060","440","1979","262500"
"3","2","1540","7210","1540","0","1984","252000"
"3","2","1430","7280","990","440","1980","250000"
"4","1","1200","7552","1060","140","1919","249000"
"3","2.5","1650","6675","1290","360","1990","246000"
"2","1.5","1078","1263","1078","0","1990","240000"
"3","2","1400","9177","1400","0","1974","233000"
"3","1","1690","7700","1690","0","1969","215000"
"4","2","1720","7560","1720","0","1959","206000"
"3","1.5","1370","7500","1080","290","1958","203000"
"2","1","800","5280","800","0","1918","195000"
"2","1","680","8640","680","0","1951","193000"
"3","1","1200","8316","1200","0","1953","190000"
"2","1","1390","11340","1390","0","1969","185000"
"2","1","810","9882","810","0","1944","170000"
"3","2.5","3930","55867","2330","1600","1957","3070000"
"4","4","6330","13296","4900","1430","2000","2390000"
"5","4.25","4830","11466","3720","1110","2014","1680000"
"4","2.5","3030","10189","2380","650","2003","1470000"
"4","3.25","4400","262666","4400","0","1988","1150000"
"4","2.5","3140","11049","3140","0","1988","990000"
"5","2.75","2590","6120","2590","0","1909","961000"
"3","2.75","2590","223027","2590","0","1983","920000"
"4","2.5","3370","7200","3370","0","2014","890000"
"5","3.5","4600","8764","3180","1420","2007","880000"
"5","4.25","3970","4500","2860","1110","2004","811500"
"4","2.75","3340","7230","3340","0","1996","808000"
"5","3","2350","6480","1650","700","1924","805000"
"4","3","3350","23781","2020","1330","1979","805000"
"4","2.25","2730","5000","1460","1270","1955","770000"
"4","2.5","2370","2971","2080","290","2008","749950"
"2","1.75","1679","577605","1679","0","2001","700000"
"4","2","2230","5000","1510","720","1922","690000"
"5","3.5","3960","25245","2500","1460","1996","650000"
"3","3","3730","383328","2230","1500","1990","649500"
"2","2.25","1390","916","1165","225","2007","625000"
"3","3.5","2490","2722","2020","470","1999","616950"
"2","1","1040","3200","1040","0","1926","580000"
"4","2","2720","8819","2240","480","1976","560000"
"3","2","2090","15790","2090","0","1992","560000"
"5","2","2280","3600","2280","0","1992","534000"
"3","2.25","2140","6720","1440","700","1961","524000"
"5","3","3720","25474","2090","1630","1986","500000"
"4","2.25","2020","8400","1350","670","1961","496600"
"3","1.75","1560","9247","1160","400","1989","490000"
"2","2.25","1330","1380","1060","270","2005","479000"
"4","2","2090","40419","2090","0","1984","460000"
"2","1.75","2060","7192","1420","640","1940","457000"
"2","2","1350","1209","1350","0","2013","455000"
"4","1.5","1580","7350","960","620","1963","452000"
"3","1.75","1880","9360","940","940","1941","445500"
"3","2.25","1850","4050","1850","0","1985","445000"
"3","1","1610","5500","1610","0","1903","440000"
"4","2.5","2470","385506","2470","0","1991","438950"
"2","2.5","1560","1222","1080","480","2008","435000"
"3","1.75","1470","7350","1470","0","1963","432500"
"4","2.25","1310","8400","1310","0","1966","421000"
"2","1","720","4592","720","0","1943","419000"
"4","2.5","2906","5893","2906","0","2014","418395"
"3","2","1410","8088","1410","0","1987","410000"
"3","1","1480","6550","1480","0","1925","398000"
"3","3.25","1370","915","1100","270","2006","388000"
"3","2.25","1680","8450","1340","340","1960","385000"
"4","2.5","2560","6238","2560","0","2007","385000"
"3","1.75","1430","10574","1430","0","1981","375000"
"3","2.75","1750","9166","1170","580","1979","370000"
"4","2.75","2020","8093","1300","720","1961","366000"
"4","1","1520","80150","1520","0","1948","365000"
"4","3.5","2690","5564","2690","0","2007","359950"
"3","2.25","2550","9674","1850","700","1959","355000"
"3","1.5","1550","40752","1550","0","1954","350000"
"2","1.75","1250","1208","1040","210","2007","349000"
"4","2.5","2380","7792","2380","0","1993","342000"
"3","1.75","3400","46382","2050","1350","1979","340000"
"4","3","2090","7500","1370","720","1986","338000"
"3","2.25","2450","6500","2450","0","1985","329000"
"3","2.5","2020","4183","2020","0","2012","321000"
"3","2.75","2770","3809","1770","1000","1925","317625"
"3","2.5","1410","1325","1180","230","2007","315000"
"3","2.5","2100","6825","2100","0","1994","305000"
"3","2.25","1760","5421","1760","0","1991","300000"
"2","1.75","1280","37373","1280","0","1996","297000"
"4","1.75","1790","5341","1050","740","1951","297000"
"3","2","1650","11256","1250","400","1957","294000"
"4","2.75","2910","7712","1600","1310","1998","292000"
"4","1.75","1990","18900","1870","120","1929","290000"
"3","1.75","1770","8240","1240","530","1978","280000"
"4","2.5","2789","3960","2789","0","2007","272000"
"2","1.5","1140","14373","1140","0","1949","262500"
"3","1.75","1380","14000","1380","0","1939","249900"
"2","2","1260","10200","1020","240","1983","230000"
"2","1.5","1160","1848","1160","0","1972","229950"
"3","2.25","1610","7084","1280","330","1968","218000"
"2","1","1000","10200","1000","0","1961","213000"
"2","2.5","1280","1566","1280","0","2005","206000"
"3","2.5","1870","3118","1870","0","1993","205000"
"3","1.5","1420","9081","1420","0","1990","202000"
"3","1.75","1100","9452","1100","0","1942","190000"
"2","1","880","6900","880","0","1943","190000"
"3","1.5","1280","4031","1280","0","1985","185000"
"2","1","1100","7323","780","320","1982","179950"
"4","4.5","4510","12873","4510","0","1998","1820000"
"6","3.5","4010","16200","2090","1920","1955","1650000"
"4","4","5050","202554","3260","1790","2000","1340000"
"3","2.75","3230","5432","3230","0","1925","1150000"
"5","3","4090","12850","2090","2000","1986","1100000"
"5","3.5","3230","7560","3230","0","2007","1080000"
"4","2.75","2500","20000","1700","800","1969","950000"
"4","2.5","3700","7051","3700","0","2006","950000"
"3","3.25","2640","16090","1960","680","1976","885000"
"4","1.75","2510","5800","1830","680","1953","880000"
"4","3.5","3020","12750","3020","0","1990","845800"
"3","1.75","1510","3600","1230","280","1910","800000"
"5","3.5","3180","14000","3180","0","1997","760000"
"3","3.5","4380","6350","2780","1600","1900","740500"
"4","2","1640","6000","1640","0","1911","735000"
"2","2","1240","9119","1240","0","1952","727500"
"4","2.5","2130","3420","1730","400","1916","725000"
"4","2","2270","5760","2270","0","1909","724950"
"3","3.25","3060","9055","2460","600","1994","715000"
"3","3.5","2630","4713","2030","600","2008","695000"
"4","2.5","2780","35000","2780","0","1985","674250"
"5","3.5","3160","5175","3160","0","2014","660000"
"3","2.5","2990","9413","2990","0","2006","659950"
"4","2.5","2260","5172","2260","0","2004","640000"
"5","3.25","3340","4166","2500","840","2014","637850"
"4","2.5","2120","3220","2120","0","2005","637250"
"5","2.75","2830","11795","1710","1120","1960","628000"
"4","2.5","2990","5122","2990","0","2004","600000"
"5","2.25","2480","12614","1860","620","1979","585000"
"2","1.75","1930","11200","1430","500","1951","581000"
"3","1.75","1800","4429","1800","0","1906","579000"
"3","2.5","2420","11953","2420","0","1990","570000"
"3","1.5","2440","7200","2440","0","1949","550000"
"3","2.5","1990","4936","1990","0","2004","544900"
"4","1.75","1520","15398","1370","150","1960","533250"
"3","2.75","2100","20150","2100","0","1955","530000"
"3","1.75","2180","14734","2180","0","1990","488000"
"2","1","1620","3880","920","700","1924","481000"
"3","1.75","1210","6175","1210","0","1976","478000"
"2","2.25","1140","1332","1140","0","1999","476000"
"4","1.75","1880","4175","1090","790","1944","475999"
"3","1","1400","4914","1400","0","1929","470000"
"4","2","1570","7320","1570","0","1960","450000"
"3","2.75","2240","3360","2100","140","2014","450000"
"5","2.5","2000","3600","1150","850","1987","441000"
"3","2.5","2080","16050","1360","720","1978","418000"
"4","3.25","3266","5969","3266","0","2014","418000"
"2","1","1110","3943","740","370","1916","410500"
"3","1.75","1520","7252","1140","380","1975","405000"
"4","3","2500","6278","2500","0","2002","395000"
"4","1.75","2690","46609","2690","0","1940","390000"
"4","2.5","2560","43560","2560","0","1989","390000"
"2","1.5","1010","948","1010","0","1999","387000"
"4","3.25","2864","8035","2864","0","2014","380000"
"3","2.25","2120","18500","2120","0","1983","375000"
"3","1","1000","6947","1000","0","1947","375000"
"2","1","920","6600","920","0","1910","365000"
"3","2.5","1930","4000","1930","0","2014","345500"
"3","1","1340","9339","1340","0","1960","345000"
"3","2.5","1520","3041","1520","0","2009","333000"
"4","2.25","2380","7400","1760","620","1979","319000"
"3","2.5","2110","7434","2110","0","1978","319000"
"6","2.75","2940","7350","1780","1160","1978","315000"
"2","1","900","8556","760","140","1941","315000"
"4","2.5","2430","5959","2430","0","2002","305000"
"4","2.5","1990","5511","1990","0","1994","302500"
"4","2.25","1600","15312","1080","520","1979","299500"
"4","2.5","2420","3825","2420","0","2003","298000"
"3","2.25","1760","7023","1760","0","1995","289200"
"3","2.5","1450","4106","1450","0","2011","279000"
"3","2.5","2100","6021","2100","0","1992","277950"
"4","2.25","2090","7400","1670","420","1973","274000"
"3","1","1090","22080","1090","0","1967","267500"
"2","1","1420","21158","1420","0","1953","250000"
"3","1.75","1550","9060","1550","0","1948","225000"
"3","1","1410","5000","980","430","1962","225000"
"2","2.5","809","940","809","0","2003","219000"
"2","2","1070","8400","1070","0","1980","217500"
"3","1","1570","9650","1570","0","1922","212644"
"3","1.75","1250","8084","1250","0","1967","209000"
"3","1","1480","5600","940","540","1947","200000"
"3","1.5","1100","32700","1100","0","1967","194820"
"3","2.25","2750","6203","1620","1130","1959","1650000"
"3","2.75","2030","7700","1400","630","1965","643000"
"4","1.75","1970","10358","1540","430","1977","385000"
"2","2.5","980","1013","980","0","2008","334900"
"4","1","800","8775","800","0","1943","268750"
"3","1.75","1540","6273","770","770","1951","263500"
"2","1","670","1675","670","0","1960","245000"
"3","1","1620","3000","1620","0","1928","599995"
"3","2.5","1690","4000","1690","0","2004","452000"
"3","2","1720","7704","1160","560","1969","402000"
"2","0.75","900","9600","900","0","1941","180250"
"3","3.5","4490","56609","4490","0","1993","3120000"
"5","4.75","5410","13431","5050","360","1941","2540000"
"4","3.5","4300","108865","4300","0","2014","1450000"
"3","2.5","2280","5000","2280","0","1926","1330000"
"6","3.5","6563","32670","5153","1410","2002","1300000"
"5","3.25","3970","8029","2970","1000","1979","995000"
"4","1.75","2210","19025","1460","750","1952","950000"
"5","2","2940","5500","2340","600","1909","950000"
"3","1.5","1340","6000","1340","0","1927","907000"
"4","3","3370","9496","3370","0","1981","905000"
"5","2.75","3460","7977","3460","0","2011","858450"
"4","2.25","2510","9963","2200","310","1967","800000"
"4","2.5","3060","6826","3060","0","2004","775000"
"4","2.5","3410","179419","3410","0","2004","774950"
"3","2.5","3170","7187","3170","0","2005","720000"
"3","2.5","1909","1300","1766","143","2006","630500"
"3","2.25","1970","4564","1470","500","1959","625000"
"3","2","2080","12094","2080","0","1982","589950"
"4","2.5","3190","7941","3190","0","2005","589450"
"4","1.75","1920","7455","960","960","1939","571500"
"4","2.5","2890","5801","2890","0","2005","570000"
"3","2","1990","3000","1230","760","1908","569000"
"3","2.5","2430","5128","1270","1160","1978","560000"
"4","1.75","2020","36400","1550","470","1976","521000"
"3","2","1670","8800","1150","520","1961","520000"
"4","2.75","2700","5150","2700","0","2009","515000"
"3","2.25","1280","6250","1080","200","2008","495000"
"2","1","850","2850","850","0","1927","489000"
"4","2.5","2870","35757","2870","0","1977","480000"
"4","1.75","2160","19283","2160","0","1981","475000"
"3","1.5","1240","8738","1240","0","1959","475000"
"3","1","1170","3348","1170","0","1924","457000"
"3","1","2020","8100","1170","850","1956","450000"
"3","2.5","2020","7800","1330","690","1958","444950"
"3","2.25","2020","2750","1680","340","2008","430000"
"2","1.75","1980","44550","1280","700","1977","428000"
"3","1","1570","11752","1570","0","1930","415000"
"3","1.75","1530","26642","1180","350","1988","410000"
"3","1.5","1510","7642","1510","0","1959","400000"
"4","2.5","2800","4687","2800","0","2005","399000"
"3","2","2620","10107","2620","0","1982","394250"
"3","2.5","2500","21780","1770","730","1986","390000"
"4","2.5","2580","4818","2580","0","2005","379950"
"2","1","960","5096","960","0","1949","379500"
"4","2","1850","8827","1850","0","1969","360000"
"4","2.5","1950","5451","1950","0","2004","360000"
"2","1","1430","365904","1010","420","1991","356000"
"3","1.5","1870","9000","1120","750","1923","350000"
"2","1.75","1270","1916","1270","0","2012","340000"
"4","2.5","2330","7050","2330","0","1998","335000"
"3","2","1490","8847","1490","0","1967","335000"
"3","1.75","1080","1306","580","500","1954","331000"
"3","1.75","1300","9079","1300","0","1986","331000"
"3","1.75","2080","5969","1080","1000","1971","329950"
"4","1","2410","6975","1510","900","1957","325000"
"3","1","1290","12231","1290","0","1976","323000"
"4","1.75","1850","8580","1140","710","1960","315000"
"3","2.25","1790","6930","1390","400","1974","304500"
"3","2.25","2100","8163","2100","0","1984","299900"
"4","2.5","1788","10183","1788","0","1990","294400"
"3","2","1760","6600","1760","0","1998","290000"
"2","2","1590","9375","910","680","1983","290000"
"3","3","2430","10500","2150","280","1983","272000"
"4","1.75","1830","5375","1060","770","1962","260000"
"3","1","1230","10170","1230","0","1979","255000"
"2","1","560","7560","560","0","1944","249900"
"4","2","1750","8116","1750","0","1943","247000"
"3","2","1190","10299","1190","0","1994","240000"
"3","1.75","1420","8738","1420","0","1966","234000"
"3","1","960","6500","960","0","1954","225000"
"3","1","1000","223462","1000","0","1933","220000"
"3","1.5","1080","9774","1080","0","1968","218250"
"3","1","1730","7950","1180","550","1961","216000"
"3","1","1260","7897","1260","0","1979","215000"
"2","1","970","8874","970","0","1968","210000"
"2","1","840","4200","840","0","1938","208417"
"2","1","860","5000","860","0","1949","199988"
"3","1","1160","18055","1160","0","1950","182000"
"3","1","960","8291","960","0","1950","158800"
"4","3.75","5150","453895","4360","790","1997","2140000"
"4","3.75","7620","29536","5980","1640","2005","1680000"
"5","3","3650","16600","1860","1790","1978","1310000"
"4","4.25","4980","13000","3080","1900","1982","1250000"
"5","2.25","3440","5000","3440","0","1901","1230000"
"3","1.5","2390","4000","1690","700","1936","978000"
"5","3.5","3420","4216","2520","900","2008","925000"
"3","1.75","2050","4080","2050","0","1991","790000"
"4","1.75","2090","5050","1090","1000","1916","775000"
"3","2","1160","13747","580","580","1931","775000"
"3","2.75","2610","11290","1630","980","1985","757000"
"4","2.75","2640","3750","1840","800","1911","750000"
"4","1.75","2700","6000","1450","1250","1953","725000"
"4","2.25","2920","17023","1690","1230","1977","707000"
"4","1.75","1730","6500","1250","480","1945","700000"
"3","1.75","2130","4400","1430","700","1922","675000"
"4","2","1530","4080","1530","0","1912","664000"
"6","2.5","3190","12196","3190","0","1979","664000"
"2","2.25","2770","11884","1570","1200","1969","645000"
"3","2.5","3610","26359","1950","1660","1998","635000"
"4","2.25","1880","3000","1760","120","1909","616500"
"3","1.75","1560","7424","1560","0","1940","592000"
"8","3","3840","15990","2530","1310","1961","575000"
"4","1.75","2060","4080","1460","600","1922","562000"
"3","3.25","1530","1786","1200","330","2007","560000"
"2","3","1650","960","1350","300","2015","559000"
"2","1","820","3700","820","0","1968","554000"
"3","2","1340","3000","1340","0","1905","549000"
"4","2.5","2000","4700","1220","780","1944","530000"
"4","2.5","2010","9075","1310","700","1959","510000"
"4","2.5","2420","5006","2420","0","2013","505000"
"4","2","2760","27631","1800","960","1978","500000"
"4","4.5","2690","7350","2690","0","1949","500000"
"4","2","2280","7200","2280","0","1956","500000"
"3","1","1600","6250","1600","0","1909","488000"
"3","2.25","1620","12309","1620","0","1987","473000"
"3","1.75","1760","11371","1760","0","1959","455000"
"4","2.25","1840","7575","1390","450","1973","442500"
"2","1.5","1130","1340","910","220","2008","439108"
"3","2","1760","2875","1290","470","1988","437500"
"3","1","1630","16393","1630","0","1969","437500"
"2","2","1400","10052","1400","0","1957","431750"
"4","3.25","3266","5398","3266","0","2014","424950"
"3","1.5","1400","1091","1400","0","2007","419500"
"4","2.75","2360","7716","1390","970","1978","405000"
"4","2.5","2578","4554","2578","0","2014","400950"
"2","1","700","3400","700","0","1946","399000"
"3","1","1980","9540","1080","900","1949","396000"
"3","2","1910","11576","1410","500","1978","390000"
"2","1","1270","1399","1270","0","2000","370000"
"6","1.75","2230","10080","1390","840","1969","360000"
"4","2.5","1912","5000","1912","0","2012","353000"
"1","1","1230","9300","1230","0","1918","349950"
"3","1","1620","10610","1620","0","1958","345000"
"3","1","1710","10190","1310","400","1949","340000"
"4","1.75","2290","7380","1390","900","1963","326000"
"3","1.5","1540","8110","1190","350","1959","325500"
"2","2.25","1550","1827","1550","0","2008","320000"
"2","1","1000","8212","1000","0","1947","305000"
"4","2.5","1820","7575","1220","600","1975","299000"
"3","2","1820","15068","1520","300","1920","283000"
"3","2","1640","5650","1640","0","2003","279000"
"4","3","2710","7199","1710","1000","1967","258000"
"1","2","1150","9812","1150","0","1962","227000"
"4","1","1640","10455","950","690","1963","218000"
"3","2.5","1650","5000","1650","0","1985","216300"
"2","1","720","9520","720","0","1947","195000"
"3","1.75","1520","9600","1520","0","1967","190000"
"3","1","920","6460","920","0","1969","189950"
"2","1","720","212137","720","0","1982","150000"
"2","1","720","4120","720","0","1915","150000"
"4","2.75","3190","19513","3190","0","1982","2130000"
"4","3.5","4440","20668","3240","1200","1965","1730000"
"4","2.75","4270","5432","4270","0","1996","1610000"
"5","2.5","2870","16238","2870","0","1962","1560000"
"4","3.75","3770","4000","2890","880","1916","1500000"
"3","1.5","1870","3300","1870","0","1906","933000"
"3","1.5","2160","2260","1620","540","1917","900000"
"4","2.5","3450","35100","3450","0","1987","832500"
"5","3.25","3230","5000","2350","880","2002","815000"
"4","3.5","3050","7020","2050","1000","1984","750000"
"4","2.75","2110","8190","2110","0","1966","746000"
"4","2.75","3660","150282","3660","0","1990","730000"
"4","2.25","2410","16650","2410","0","1965","711800"
"3","3","1970","20978","1770","200","1980","705000"
"2","2.5","2390","7489","2390","0","2007","699950"
"3","2","2080","8000","1040","1040","1926","660000"
"3","2.75","1540","1251","1230","310","2002","650000"
"3","3","2330","10327","2330","0","1998","612000"
"3","2.5","2180","40278","2180","0","1985","580000"
"3","1.75","2270","10136","2270","0","1979","575000"
"4","2.5","2520","13156","1520","1000","1979","565000"
"3","2","1580","5289","870","710","1940","563000"
"1","1","830","3200","830","0","1924","525000"
"2","1.75","1850","2530","1850","0","1903","495000"
"3","2","1580","4010","790","790","1909","489950"
"4","3.5","3273","5115","2671","602","2014","485000"
"3","2.25","2620","10659","1660","960","1976","469000"
"2","1.5","1510","2001","1510","0","1985","445000"
"3","1.75","1750","16748","1330","420","1978","435000"
"4","2.25","2200","8384","1250","950","1959","425000"
"5","2.75","2540","27007","1520","1020","1980","420000"
"4","2.5","2250","6840","2250","0","1987","395000"
"5","2.5","2390","8775","1270","1120","1980","358000"
"5","2.75","1540","4000","1140","400","1990","357000"
"3","1.5","1240","15867","1240","0","1962","355000"
"3","1","1390","2640","1230","160","1903","345000"
"3","2.5","1560","9600","1210","350","1964","324950"
"3","2.5","1320","3150","1320","0","2005","299950"
"3","2.5","1690","4102","1690","0","2003","295000"
"3","1.75","1910","10230","1290","620","1964","250000"
"4","3","1800","2500","1800","0","2000","250000"
"3","2","1670","6824","1300","370","1990","223000"
"3","1.75","1280","10016","1280","0","1975","215000"
"2","1","1130","8160","1130","0","1952","207000"
"3","1.75","1240","10361","1240","0","1987","192000"
"3","1.5","1200","2002","1200","0","1966","140000"
"1","1","560","5700","560","0","1947","106000"
"4","3.5","3130","52322","2430","700","2011","975000"
"3","2.5","1230","922","1080","150","2009","399950"
"4","2.5","3216","5902","3216","0","2014","498445"
"3","1","1520","7200","1030","490","1954","226000"
"3","1","980","2490","980","0","1969","90000"
"3","2.25","3040","52302","3040","0","2005","1000000"
"5","3.5","5230","8960","4450","780","2014","1990000"
"4","4.25","4285","9345","4285","0","2013","1890000"
"3","3.5","4660","21164","4660","0","1975","1640000"
"6","3.5","3720","11690","3720","0","2003","1520000"
"5","3.5","3420","8000","3420","0","2006","1440000"
"4","2.75","2660","9547","1930","730","1968","1440000"
"4","2.25","3270","6000","2180","1090","1909","1210000"
"4","3.25","3960","12895","3960","0","2001","1190000"
"4","2.5","3830","13800","2030","1800","1969","1100000"
"4","4","4090","51908","4090","0","1991","1040000"
"4","4","5635","9695","4360","1275","2011","950000"
"4","2.5","3640","6389","3640","0","2014","932990"
"5","3","2640","5096","2640","0","2009","910000"
"2","1.5","1140","7800","1140","0","1947","903000"
"3","2.25","2550","4089","2550","0","1983","834000"
"3","1.75","1740","8560","1500","240","1948","827235"
"6","4.25","5480","189050","5140","340","1991","800000"
"4","3.5","3290","20107","2220","1070","1990","799000"
"3","2.75","2590","12063","2590","0","1993","796500"
"3","1.75","3520","12350","1530","1990","1960","775000"
"5","2.75","2920","9163","1520","1400","1976","713500"
"3","1","1220","8573","1220","0","1954","672000"
"3","1","1400","1581","1400","0","1909","667000"
"4","1.5","1960","4500","1960","0","1922","660000"
"4","2.5","2160","7000","2160","0","1989","653000"
"3","2.25","3280","79279","3280","0","2001","645000"
"3","1.5","2240","5300","1120","1120","1955","635000"
"4","1.5","2720","37258","2720","0","1994","632500"
"3","1.75","2220","7224","2040","180","1975","615000"
"4","1.75","2250","5562","2250","0","1967","605000"
"4","2","3410","15143","3410","0","1972","599000"
"2","1.75","1840","4076","1140","700","1957","575000"
"4","2.75","1610","11201","1020","590","1982","575000"
"4","1.75","1710","8947","1710","0","1956","571900"
"3","2.5","2020","11935","2020","0","1976","560000"
"4","1.75","2260","11000","1620","640","1976","555000"
"4","2.25","1720","2300","860","860","1940","555000"
"4","2.5","2520","4831","2520","0","2009","536000"
"2","1","910","4725","910","0","1949","515000"
"5","2.75","2980","4502","2980","0","2007","515000"
"3","1.5","2220","8994","1110","1110","1962","500000"
"4","2.5","1900","5001","1200","700","2008","500000"
"4","3","3620","403693","3620","0","1980","495000"
"3","1.75","1600","6250","1600","0","1984","490000"
"3","1","1160","8800","1160","0","1959","480000"
"4","2.5","3160","7210","1880","1280","1969","467500"
"3","1.75","2660","5511","1330","1330","1948","467000"
"3","1.75","1480","6360","1480","0","1954","465000"
"2","1","1430","12092","1430","0","1938","460000"
"4","2.25","2690","36114","2690","0","1986","460000"
"3","2.5","1650","1838","1270","380","1991","453000"
"4","2.75","2900","6400","2040","860","1911","450000"
"2","1","1130","5413","880","250","1939","443000"
"2","1.5","1090","4013","1090","0","1900","430000"
"3","1.75","1680","8610","1290","390","1969","427000"
"3","1.75","1530","9800","1530","0","1958","425000"
"3","1","1240","7300","1240","0","1968","420000"
"2","1.5","1370","4102","1370","0","1987","405000"
"3","2.75","2020","9505","1260","760","1969","401000"
"4","1.75","1690","7680","890","800","1946","400375"
"3","2.5","2580","214315","2580","0","1946","400000"
"4","2.5","1950","7350","1150","800","1963","385000"
"3","3.25","1370","1227","1370","0","2007","375000"
"3","1.5","1560","7884","1060","500","1969","368000"
"4","1","1020","11383","1020","0","1947","364000"
"3","2.5","1850","10800","1850","0","2010","359782"
"3","2.5","1880","5290","1250","630","1974","355000"
"5","2.5","2540","5100","2540","0","2014","355000"
"3","1","1010","7680","1010","0","1967","350000"
"4","2.25","2190","3850","2190","0","2006","350000"
"2","1.75","1820","8409","910","910","1948","345000"
"3","2.25","1200","2845","1200","0","1986","342000"
"3","1","980","9903","980","0","1966","335000"
"2","1","950","3090","950","0","1909","330000"
"4","1.75","1730","9520","1730","0","1971","320000"
"3","1.75","1810","21138","1240","570","1977","300000"
"3","2.5","2450","7062","2450","0","1993","299000"
"4","2.5","1610","4052","1610","0","2013","286950"
"5","2.75","2770","6116","1490","1280","1979","283450"
"2","1.5","1190","1265","1190","0","2005","280000"
"3","1.75","1370","4000","1370","0","1966","268000"
"3","2.5","1850","7875","1250","600","1968","260000"
"3","2.25","1400","10436","1040","360","1985","258900"
"3","2","1790","7879","1790","0","1998","258000"
"3","2","930","11475","930","0","1978","255000"
"3","2","1290","5000","1290","0","1990","253000"
"3","1","1060","52272","1060","0","1960","250000"
"2","1","700","6046","700","0","1950","247500"
"4","2.5","1980","7264","1980","0","1996","240000"
"3","1","1060","10228","1060","0","1948","230000"
"2","1","810","5100","810","0","1955","229000"
"4","2.5","1700","6031","1700","0","1994","225000"
"2","2.5","1000","1092","990","10","2004","220000"
"3","1","1960","9583","1960","0","1908","180000"
"3","1","1130","9907","1130","0","1954","179950"
"3","1.5","1390","1882","1390","0","2014","175003"
"4","2.25","2870","6000","1730","1140","1951","1270000"
"6","2.25","2550","5000","2550","0","1907","1020000"
"4","2.5","4070","57587","4070","0","1989","965000"
"4","2.75","2980","42253","1860","1120","1973","949000"
"4","2.5","3540","18168","3540","0","1996","925000"
"4","2.5","4600","67369","4600","0","1990","800000"
"3","1.5","1960","2400","1330","630","1911","792500"
"3","1","1660","4400","1460","200","1911","780000"
"3","2.25","1640","1873","1640","0","2014","759000"
"3","2.75","2870","6600","2870","0","1984","755000"
"3","2.5","1960","3060","1960","0","2010","732000"
"3","1","940","8377","940","0","1952","725000"
"2","2.5","2300","6400","2300","0","2007","705000"
"5","1.75","1790","9335","1790","0","1952","695000"
"4","1.75","2280","3680","1470","810","1926","665000"
"6","2.75","3610","10003","3610","0","1966","650000"
"4","2","1610","8976","1610","0","1966","650000"
"3","2.5","1860","10027","1860","0","1993","625000"
"5","2.5","2720","5000","1530","1190","1939","580000"
"6","2.5","3370","15625","1770","1600","1964","570000"
"4","1.75","2350","6200","1410","940","1946","555000"
"3","2","1650","3952","1650","0","1950","550000"
"4","2.5","2720","13500","1510","1210","1969","549950"
"4","2.5","2500","50595","2500","0","1997","545000"
"3","3.5","2620","10137","1970","650","1992","538000"
"2","2","1370","3827","1020","350","1952","535000"
"3","2.75","2160","4086","1380","780","1987","528000"
"4","2.5","2490","34947","2150","340","1985","520000"
"3","3","2330","7304","1300","1030","1971","516000"
"3","2","2350","266151","2350","0","1983","510000"
"2","1","1060","3588","960","100","1926","506000"
"3","2.5","1300","1187","1300","0","2005","505500"
"3","2.5","1460","4961","1150","310","1988","475000"
"4","2.5","2240","7245","1140","1100","1972","475000"
"4","2.25","2170","8050","1220","950","1976","466000"
"3","2.5","1450","5175","1030","420","1995","465000"
"3","2","1150","4500","1150","0","1917","450000"
"3","2.25","2530","27227","2530","0","1987","450000"
"2","1","950","4560","950","0","1925","450000"
"5","2.5","2250","7945","1360","890","1977","446950"
"3","2.25","1460","968","1140","320","2003","443750"
"4","1.5","1690","3245","1690","0","1929","440000"
"4","2.25","2600","28600","1810","790","1968","440000"
"4","2.5","2495","5751","2495","0","2002","436000"
"6","2","3080","5500","3080","0","1900","432500"
"3","2.5","1630","10762","1630","0","1994","425000"
"2","1","2100","4480","1400","700","1908","420000"
"3","3.5","1900","2133","1520","380","2009","420000"
"3","1.5","2270","8187","1420","850","1954","410000"
"3","3.25","2650","7819","1760","890","1956","410000"
"3","1.75","1720","7202","1720","0","1995","404000"
"2","1","720","3255","720","0","1905","403000"
"3","1.75","1920","9102","1920","0","1968","400000"
"3","1","1460","8290","1460","0","1959","399000"
"3","2.5","2350","5100","2350","0","2003","390000"
"3","2.5","2160","59241","2160","0","2007","389900"
"4","2.5","3190","9856","3190","0","1979","387500"
"4","2.75","2960","10454","2360","600","1979","385000"
"4","1","1740","4400","1740","0","1924","382000"
"3","2.5","1260","900","940","320","2007","380000"
"3","2.25","1540","1561","1540","0","2010","375000"
"3","2.75","1250","1655","830","420","2006","370000"
"3","1.5","1590","6750","1080","510","1976","357000"
"3","1.75","2370","9750","1280","1090","1979","355000"
"5","2.75","2130","5000","1100","1030","1978","353000"
"4","1.75","1820","6930","1320","500","1952","350000"
"3","1.75","1740","29597","1740","0","1965","350000"
"2","1.5","830","1077","830","0","2006","350000"
"2","1.75","1550","9230","970","580","1969","349900"
"2","1","1180","9261","940","240","1957","343000"
"3","2.25","1900","8125","1540","360","1969","340000"
"2","1","860","7102","860","0","1947","340000"
"3","2.5","2370","9102","2370","0","1990","330000"
"2","2.25","1230","1078","1160","70","2008","325000"
"4","1","1460","7200","1460","0","1955","320000"
"2","1","900","2728","900","0","1998","290000"
"2","1","1280","12500","1060","220","1951","281000"
"3","2.5","1800","8697","1800","0","1987","280000"
"3","1","940","7913","940","0","1948","280000"
"5","1.5","1930","7480","1930","0","1966","270000"
"3","2.5","1770","7336","1770","0","1996","270000"
"3","1.75","1410","1899","1410","0","2014","267800"
"3","1.75","1710","6400","1240","470","1976","260000"
"3","1.75","1040","5650","1040","0","1951","258000"
"3","2","1470","2781","1470","0","2003","250000"
"3","1","1752","14626","1752","0","2005","249000"
"3","1.5","1360","9980","1360","0","1966","244900"
"2","2","1200","3624","1200","0","2003","234000"
"2","2.25","850","1656","850","0","2001","233000"
"3","1.5","910","5120","910","0","1973","232900"
"6","1.5","2140","36509","2140","0","1903","230000"
"3","1","1000","16376","1000","0","1959","228000"
"3","1","970","7790","970","0","1967","219000"
"4","2","1520","6174","1520","0","1920","210000"
"3","2","1440","10111","1440","0","1963","210000"
"3","1","1330","6900","1330","0","1976","209000"
"3","1","1520","8450","1120","400","1961","135000"
"4","4.25","6410","43838","5610","800","1906","2730000"
"4","3","3540","11098","3000","540","1940","2200000"
"5","3.5","4870","7700","3650","1220","1929","1740000"
"5","3","4290","17100","2480","1810","1972","1710000"
"5","3.75","4700","11237","2930","1770","2006","1140000"
"4","2.5","2780","10480","1390","1390","1967","990000"
"4","2.5","3670","315374","3670","0","1994","921500"
"3","2.5","2320","5000","1620","700","1907","900000"
"6","2.75","3500","5150","2430","1070","1909","865000"
"3","1.75","1490","3840","1490","0","1984","835000"
"3","2.5","1810","7200","1310","500","1960","827500"
"4","3.5","3470","7396","2520","950","1979","810000"
"3","1.75","2150","2527","1400","750","1906","762000"
"3","1.75","1520","5500","1520","0","1936","738000"
"3","1.5","2180","5000","1090","1090","1941","720000"
"4","2.5","2672","4297","2020","652","2005","700000"
"4","2.5","2920","6000","2920","0","2004","675000"
"3","2.25","3340","13805","3340","0","1950","670000"
"3","2.25","2230","11835","1630","600","1974","652450"
"3","1.75","2040","4005","1740","300","1930","620000"
"2","1","1470","6398","970","500","1941","602000"
"2","2","1660","5200","1120","540","1906","601150"
"3","2.5","3360","218235","3360","0","1989","590000"
"3","2","2690","435600","2690","0","1992","575000"
"5","2.5","2410","8960","1600","810","1978","560000"
"3","2.25","1540","1005","1540","0","2008","550000"
"4","2.25","1580","7307","1160","420","1973","525000"
"3","2.5","2100","12338","2100","0","1997","521900"
"3","2.25","2510","43995","2510","0","1981","520000"
"4","2.5","2800","21370","2800","0","2003","515000"
"3","2.25","1300","1180","1300","0","2008","515000"
"2","1.75","1810","7523","1170","640","1962","501000"
"3","3.25","1490","902","1220","270","2001","500000"
"3","1.75","1800","7199","1300","500","1972","500000"
"2","1","1420","4635","1420","0","1941","496000"
"2","1","950","3960","950","0","1941","482000"
"3","2.25","1850","2575","1850","0","2013","474950"
"2","1","1090","3160","840","250","1926","474000"
"4","1.75","1760","5750","1070","690","1962","471000"
"4","2.5","2811","7251","2811","0","2009","455000"
"3","2.5","2690","21883","2690","0","1994","445000"
"3","2","1650","6408","1650","0","1977","440000"
"2","1","990","3120","790","200","1907","437500"
"4","2.25","1990","8548","1990","0","1973","435000"
"3","2.25","1830","6460","1400","430","1976","430000"
"3","2.5","2210","7000","2210","0","1985","412000"
"3","1.75","1440","9065","1440","0","1972","409000"
"5","2.75","2470","19200","1250","1220","1977","400000"
"4","3","2150","64694","1450","700","1969","399950"
"4","2.5","2600","8921","2600","0","1991","392000"
"4","1.5","2140","7920","1190","950","1959","378000"
"4","2","1720","2410","970","750","1930","375000"
"2","1.5","1050","1046","960","90","2007","375000"
"2","1","1140","15624","1140","0","1909","365500"
"4","1","2180","10617","2180","0","1950","359000"
"1","0.75","530","33278","530","0","1950","355000"
"4","2.25","1570","499571","1570","0","1972","350000"
"3","2","1060","1184","730","330","2006","346000"
"2","1","1770","16660","1220","550","1957","345000"
"3","1.75","1280","16200","1030","250","1976","340000"
"4","2","1750","5202","1070","680","1942","330000"
"3","1","1050","9083","1050","0","1951","325000"
"3","2","1570","5600","1570","0","1999","325000"
"4","2.75","2060","6659","1280","780","1981","322500"
"3","1.75","1900","7076","1130","770","1977","315000"
"4","2.5","1580","6633","1580","0","1984","291000"
"3","1.75","1990","6500","1090","900","1961","285000"
"3","2.5","1490","8005","1090","400","1976","271500"
"4","1.5","2040","10488","1190","850","1961","261000"
"4","1","1740","8100","1020","720","1962","260000"
"4","2.75","1830","6643","1830","0","2001","250000"
"3","2.25","1640","7630","1180","460","1968","247000"
"2","1.5","1260","9693","1260","0","1957","245560"
"3","2.25","1460","5818","1140","320","1986","240000"
"3","1.5","1890","9000","1190","700","1959","240000"
"3","1","1340","10035","1340","0","1959","227000"
"3","2.5","1740","10050","1740","0","1989","225000"
"3","1","1320","3954","1320","0","1912","209000"
"2","1","710","14700","710","0","1926","187250"
"5","1","1460","11726","1290","170","1936","180000"
"5","3","3950","9520","2250","1700","1953","1270000"
"5","2.75","3710","13874","2340","1370","1977","1250000"
"4","2.5","3000","10920","1550","1450","1969","1080000"
"4","3.25","4010","13797","4010","0","2003","972000"
"3","2.5","1820","6848","1820","0","1953","875000"
"4","2.75","4030","10240","3310","720","1943","835000"
"5","2.25","2020","8400","1010","1010","1963","750000"
"3","2.5","2970","11985","1770","1200","1995","745000"
"3","1","2090","4000","1890","200","1931","717500"
"2","2","1615","4590","1615","0","1906","665000"
"2","1","960","6263","960","0","1942","660000"
"4","2.5","2280","7219","2280","0","1987","626100"
"4","2.5","2280","14290","1510","770","1942","622100"
"2","2","1510","4000","1010","500","1900","595000"
"4","1.5","1810","3400","1810","0","1926","560000"
"4","3.5","3540","4750","3540","0","2003","550000"
"3","2.75","2000","7204","1250","750","1960","538000"
"3","2.25","1240","1250","1240","0","2014","529950"
"5","2.25","2940","38009","1700","1240","1977","528000"
"4","2.25","2270","8480","1310","960","1973","527500"
"3","1.75","2060","58341","1100","960","1982","510000"
"8","5","2800","2580","1880","920","1997","490000"
"3","4","1390","1569","1150","240","2006","458000"
"3","2.25","1750","12408","1150","600","1962","456150"
"4","1.75","1850","7730","1100","750","1956","450000"
"3","2","1230","1613","1010","220","2003","439950"
"4","1.75","2160","7700","2160","0","1977","429000"
"3","1.5","1900","43186","1300","600","1971","427500"
"4","2","1490","5300","1110","380","1977","425000"
"3","1.75","1720","5000","1720","0","1932","420000"
"3","2.25","1830","7500","1330","500","1968","419995"
"3","2","1450","6081","1450","0","1969","405000"
"4","2","2070","10800","2070","0","1982","400000"
"2","1.5","1050","934","960","90","2007","390000"
"5","2","2020","4000","2020","0","1950","385000"
"4","2.5","2630","5701","2630","0","2010","385000"
"2","1.5","1320","73600","1320","0","1993","350000"
"1","1","790","4590","790","0","1911","350000"
"2","1.5","1040","8526","1040","0","1953","343000"
"4","2.5","2690","6099","2690","0","1998","340000"
"4","1","1400","6739","1000","400","1954","325088"
"3","1","1330","9540","1330","0","1971","320000"
"3","1.75","1480","6800","1480","0","1968","315000"
"4","2.5","1930","7014","1930","0","1994","310000"
"5","2.5","2100","17825","1400","700","1974","309900"
"3","1.5","1250","8700","1250","0","1959","306000"
"3","1","1000","8320","1000","0","1951","295000"
"3","2.5","1760","2688","1760","0","2005","294500"
"4","2.5","2060","5950","2060","0","2000","292000"
"3","1.5","1040","9997","1040","0","1955","290000"
"3","2.25","1430","7222","1430","0","1993","280000"
"4","2.5","2550","7500","1750","800","1976","277500"
"4","1","1360","6000","1020","340","1944","273500"
"5","2.25","2200","9600","1100","1100","1963","268450"
"4","2.5","2040","4443","2040","0","2001","265000"
"3","1","1080","4930","1080","0","1950","265000"
"3","1.5","1020","11410","1020","0","1959","255000"
"3","2","1660","13085","1010","650","1985","250000"
"2","1","700","8301","700","0","1953","248000"
"3","1","1600","12566","1600","0","1971","240000"
"3","2","1290","7952","1290","0","1998","237000"
"3","1","1660","8800","960","700","1963","209950"
"3","1.75","1420","6980","820","600","1980","205000"
"3","1.75","1160","5200","1160","0","1977","199500"
"3","1","1200","8360","1200","0","1948","160000"
"3","1.75","1010","6552","1010","0","1969","147500"
"4","4.25","5540","15408","4280","1260","2006","2580000"
"3","4.5","3950","6134","2880","1070","1998","1930000"
"5","2.25","3580","16789","3580","0","1966","1410000"
"4","2.5","3180","10319","3180","0","1986","1230000"
"4","3.25","4060","20822","4060","0","1991","1180000"
"3","2.25","2206","82031","866","1340","1983","780000"
"4","2.75","3410","5838","3410","0","2012","743000"
"4","3","2820","11500","2820","0","1991","692500"
"4","2.75","3130","8920","3130","0","2014","690500"
"4","2.5","2740","8120","2740","0","1999","690000"
"3","2.25","2070","2833","1490","580","1966","675000"
"4","2.25","2760","12100","2760","0","1976","675000"
"3","1.75","2030","9032","2030","0","1963","660000"
"4","2.75","2140","4000","1190","950","1951","625000"
"3","3.5","1970","5079","1680","290","2007","590000"
"3","2.25","2230","10026","1430","800","1975","585188"
"3","3.25","3050","12700","2240","810","1990","585000"
"2","2","1760","7200","880","880","1946","579000"
"2","1.5","1350","4592","1070","280","1939","567500"
"5","3","2560","12480","1590","970","2012","565000"
"3","2.25","2150","9250","2150","0","1984","559500"
"3","2.5","3070","14400","1720","1350","1985","550000"
"5","2.5","2380","91476","1580","800","1976","529000"
"3","2.5","2130","219978","2130","0","1986","515000"
"2","2.25","1470","1101","1340","130","2005","510000"
"2","1","680","5250","680","0","1922","500000"
"5","2.25","2710","22120","1410","1300","1955","495200"
"2","1.75","2060","2700","1030","1030","1929","485000"
"2","2.75","730","5000","730","0","1929","464000"
"2","3","1790","1709","1400","390","2001","450000"
"4","2.25","1990","7320","1030","960","1965","450000"
"5","2.5","1990","6840","1990","0","1974","438000"
"5","3","2500","5750","1430","1070","1999","430000"
"4","2","1390","4500","1390","0","1908","425000"
"3","1.75","2020","8531","2020","0","1965","405000"
"3","1.75","1860","5750","1300","560","1918","400000"
"3","3","1550","1608","1280","270","2001","390000"
"4","1.5","1780","7914","1780","0","1962","372000"
"4","2.5","2370","6557","2370","0","1998","369000"
"4","3","2250","12142","2250","0","1986","363000"
"4","1.75","1750","18810","1220","530","1977","360000"
"3","1","890","9870","890","0","1960","358000"
"4","2.75","2700","49428","2700","0","1988","357000"
"4","1.75","1570","9670","1170","400","1959","356500"
"4","2.5","2380","7850","2380","0","1995","340000"
"4","1.5","1790","17925","1790","0","1951","338000"
"4","2.5","2980","5674","2980","0","2003","330000"
"2","2.25","1550","2079","1550","0","2008","328000"
"3","2.5","2550","4240","2550","0","2006","325000"
"3","1","1160","7202","1160","0","1957","324000"
"2","1","1070","32633","1070","0","1930","320000"
"3","1","1280","6726","1280","0","1958","299500"
"3","1","1510","142803","1510","0","1974","299000"
"4","2.25","1400","7341","1300","100","1961","294450"
"3","1.75","1800","7763","1470","330","1984","270000"
"3","2.75","1740","8436","1140","600","1967","239999"
"3","2","1280","13356","1280","0","1994","232000"
"2","1","1480","5325","1120","360","1925","215000"
"2","1","1200","9850","1200","0","1921","189000"
"2","1","1000","16524","1000","0","1913","115000"
"3","2","1780","1750","1400","380","1927","760000"
"3","3.5","2710","3326","1650","1060","2005","615000"
"3","2.25","2160","6527","1580","580","1987","430000"
"2","1","1140","3834","1140","0","1911","320000"
"4","2.25","2390","7350","2390","0","1990","319000"
"2","1","720","6400","720","0","1943","285000"
"3","2.5","3560","11448","3560","0","1997","843500"
"3","1.75","1540","1044","1540","0","2014","549000"
"6","4.75","5540","7200","3950","1590","1909","2630000"
"4","3","4750","21701","4750","0","1976","2180000"
"4","3","2860","10292","2860","0","1953","1320000"
"4","4.5","5120","41327","3290","1830","2008","1240000"
"5","3.25","3510","10930","3510","0","2013","1010000"
"5","2.25","3320","11350","1660","1660","1963","989900"
"5","2.75","3750","8279","3750","0","2001","910000"
"4","2.5","3190","49658","3190","0","1999","864000"
"3","2","3200","18184","2000","1200","1977","851500"
"5","3.25","2450","6534","1770","680","1951","849000"
"4","2.75","3540","13515","3540","0","1998","820000"
"4","2.5","2390","10000","1590","800","1975","800000"
"3","1.75","1890","10292","1890","0","1969","800000"
"5","2","3920","5250","2560","1360","1910","760000"
"4","2.5","3290","7538","3290","0","2004","750000"
"4","2.75","3800","9606","3800","0","2008","730000"
"4","2.5","2180","3893","2180","0","1999","726500"
"4","2.25","2120","3794","1420","700","1926","720168"
"5","3.25","3060","11778","3060","0","2004","708000"
"4","2.5","3220","6399","3220","0","2004","697000"
"4","2.25","2360","2500","1520","840","2001","695000"
"5","3.5","3860","9600","2660","1200","1973","670000"
"4","2","2350","8000","2350","0","1977","659000"
"3","2","2800","10501","1400","1400","1954","650000"
"3","1","1430","4240","1430","0","1924","650000"
"3","2.5","2930","19900","2930","0","1983","645000"
"3","1.75","3020","360241","3020","0","1992","617000"
"3","1","1850","5000","1850","0","1922","611000"
"3","2.5","2680","43995","2680","0","1986","600000"
"2","1","2120","6897","1060","1060","1923","600000"
"3","2.5","2290","5089","2290","0","2001","585000"
"4","2.5","2950","10003","2950","0","2006","551500"
"4","2.5","2850","6809","2850","0","2003","550000"
"4","1.75","2800","90169","2800","0","1934","529000"
"3","1.75","3000","5413","1900","1100","1963","523000"
"4","2.75","2520","54014","1720","800","1979","508500"
"3","1.5","2210","6500","1030","1180","1912","500000"
"2","2.25","1600","80400","1600","0","1978","492500"
"4","2.25","2020","85813","2020","0","1995","490000"
"3","1","1470","13457","1470","0","1963","475000"
"3","2.5","2680","13457","1340","1340","1989","475000"
"4","1.75","1810","21650","1810","0","1961","465000"
"2","2.25","1390","1222","1340","50","2009","465000"
"3","2.25","2250","8000","1460","790","1976","459900"
"4","1","1330","9715","970","360","1957","458450"
"5","1.75","3690","36036","1890","1800","1985","440000"
"4","2.5","2720","7043","2720","0","2003","408500"
"2","1","800","6016","800","0","1942","405000"
"2","1","880","5111","880","0","1931","400000"
"3","2.5","1470","4488","1470","0","1980","399950"
"3","1.5","1000","13991","1000","0","1956","390000"
"3","1.75","1580","7000","1180","400","1976","370000"
"4","2.5","2720","7350","2720","0","1989","368000"
"4","2","1920","7803","1080","840","1962","360000"
"4","3","2590","7213","2590","0","2001","355000"
"3","2.5","1860","5321","1860","0","2000","326995"
"3","3.25","1480","983","1180","300","2013","315000"
"4","1","1190","7620","1190","0","1926","312000"
"3","1","1210","7649","1210","0","1956","310000"
"3","1.75","1320","6600","1320","0","1988","292000"
"4","3","1984","4460","1984","0","2012","292000"
"2","1","1340","9840","1340","0","1949","290000"
"4","2.5","2660","4082","2660","0","2010","287000"
"2","2.5","1420","2229","1420","0","2004","278000"
"3","1.75","1440","8050","1440","0","1985","258950"
"1","1","620","8261","620","0","1939","244900"
"4","1.75","1650","6900","910","740","1978","238000"
"3","1.75","1430","8505","1430","0","1968","225000"
"3","2","1100","5200","1100","0","1969","225000"
"2","1","960","13438","960","0","1951","208000"
"3","1","1240","9198","1240","0","1959","185000"
"3","1","780","3540","780","0","1920","180000"
"2","1","730","6000","730","0","1950","174950"
"2","1","1170","8254","1170","0","1949","104950"
"4","4","4130","5575","2860","1270","1993","2750000"
"3","2.25","3360","7108","2770","590","1905","2190000"
"5","3.75","4320","39094","4320","0","1938","1800000"
"4","3.5","4060","9486","4060","0","2005","1600000"
"4","3.25","4290","12103","2690","1600","1997","1400000"
"5","3.5","5150","12230","3700","1450","2007","1380000"
"5","3.5","3700","8504","2750","950","1950","1300000"
"4","2.5","2720","16454","1870","850","1963","1280000"
"4","2.25","2840","20242","2240","600","1972","1150000"
"4","2.25","2420","15482","2420","0","1925","975000"
"5","2.75","2580","7630","1730","850","1954","915000"
"6","4","3180","6551","3180","0","2014","859950"
"2","2.5","2830","8630","2830","0","2001","795000"
"3","2.5","3040","34670","3040","0","1983","790000"
"4","2.5","3060","8167","3060","0","2005","753000"
"4","2.5","3070","5762","3070","0","2000","725786"
"4","2.5","2440","14470","1660","780","1970","699000"
"6","2.25","2770","5854","2120","650","1921","685000"
"4","2.5","2980","8770","2980","0","1990","680000"
"5","2.25","2610","4080","1750","860","1909","678940"
"4","2.75","2670","6780","1630","1040","1908","675000"
"4","3","3280","4904","3280","0","2005","634800"
"4","3","1960","5562","1050","910","1965","604000"
"4","2.5","2520","10850","1680","840","1968","600000"
"3","1.75","2030","32565","1600","430","1981","597500"
"3","2","1170","6750","800","370","1947","592500"
"3","2.75","1670","1350","1350","320","2014","589950"
"4","2.75","1960","48787","1960","0","1983","565000"
"3","2.25","2220","15757","1280","940","1982","558000"
"3","2.25","2570","7242","2170","400","1951","538000"
"3","2.5","1850","1499","1790","60","2005","535000"
"3","2.25","1290","1182","1000","290","2006","525000"
"4","1.5","1710","4600","1710","0","1924","495800"
"4","1.75","1870","9500","1090","780","1962","490000"
"5","3","2240","15435","1390","850","1952","480000"
"2","1","1220","4000","1220","0","1908","470000"
"2","1","900","5512","900","0","1947","470000"
"3","2.5","2870","25663","2870","0","1988","465000"
"4","3.5","2000","2309","2000","0","2008","456500"
"4","2.25","2120","50965","2120","0","1996","450000"
"3","1.75","1410","5100","1110","300","1954","445000"
"3","2.25","1770","8000","1350","420","1976","436000"
"2","1.75","1320","2609","920","400","1938","422000"
"3","3","2680","12285","2680","0","1970","417400"
"6","2","2800","29985","1400","1400","1954","405000"
"4","2.5","2820","6666","2820","0","2007","398500"
"5","3","2140","5937","1280","860","1978","367777"
"2","1","1120","4800","770","350","1926","363000"
"3","1.75","1150","17585","1150","0","1964","361000"
"4","2.25","2390","11250","2390","0","1988","359500"
"3","2.25","1410","1332","1290","120","2004","355000"
"4","1.75","1870","7575","1480","390","1972","348500"
"3","2.25","1690","14615","1690","0","1979","345000"
"2","2.5","1100","1760","1100","0","1997","340000"
"3","2.5","1690","1760","1410","280","2014","338000"
"3","1.75","1400","6000","700","700","1919","337000"
"4","2.25","2440","8098","2440","0","1983","330000"
"3","1.75","1910","8329","1910","0","2004","323000"
"2","1.75","1200","2622","800","400","1956","306000"
"5","2.75","2790","4807","2140","650","1949","288000"
"4","2","2100","8160","1200","900","1959","283000"
"4","2.5","2009","4800","2009","0","2012","279000"
"2","2","1480","6075","740","740","1919","276000"
"4","1.75","1690","6000","1690","0","1957","275000"
"4","2.25","1700","7056","1700","0","1999","269500"
"3","2.5","1805","3402","1805","0","2009","266000"
"3","2.5","1880","5000","1880","0","2010","261950"
"2","1","770","7200","770","0","1951","257000"
"3","1","1340","6120","1340","0","1920","255000"
"4","2.5","1790","5257","1790","0","1996","251100"
"4","1.5","1850","7547","1850","0","1960","245000"
"3","1.5","1310","10491","1310","0","1969","225000"
"3","1.75","1100","10125","1100","0","1969","224000"
"3","1.75","1650","8850","1650","0","1959","220000"
"3","1","1210","8000","1210","0","1954","219950"
"3","1.5","1100","33600","1100","0","1967","215000"
"3","1","1100","9750","1100","0","1966","192500"
"3","1","990","12696","990","0","1936","173250"
"2","1.75","6840","10000","4350","2490","2001","3280000"
"5","3.25","3680","10300","3680","0","1927","1480000"
"4","2.75","2990","7389","2090","900","1923","1080000"
"4","5.25","4140","14757","4140","0","2005","1060000"
"3","1.75","2150","4200","1140","1010","1960","950000"
"5","3.25","4150","7100","4150","0","2013","929000"
"3","2.5","2960","6856","2960","0","2009","835000"
"3","2.5","2760","6187","2760","0","2014","834538"
"4","2.75","3400","7081","3400","0","2001","828200"
"3","2.5","3820","35016","3820","0","1987","775000"
"4","2.25","2040","8315","1480","560","1958","760000"
"3","1.75","2020","9478","2020","0","1961","740000"
"3","1.5","2120","4370","2120","0","1904","733500"
"4","2.5","2870","5118","2870","0","2006","725000"
"4","2.5","3160","13063","3160","0","1999","693000"
"4","2.5","3320","38043","3320","0","1997","685000"
"3","2.5","1790","2375","1790","0","2007","670950"
"3","2.5","1940","8196","1940","0","1991","661000"
"3","2.25","2150","21235","1590","560","1959","650000"
"4","2.5","2580","7465","2580","0","1993","620000"
"3","2.25","2400","16301","1400","1000","1962","595000"
"3","2.25","1640","12000","1180","460","1967","575950"
"3","1","1590","4600","1290","300","1926","572500"
"3","1","1130","7500","880","250","1947","550000"
"3","2.5","2060","8123","1010","1050","1977","541338"
"3","3.25","2670","5108","2670","0","2000","535000"
"3","3.5","2490","3517","1720","770","2005","533500"
"3","2.5","2640","13775","1550","1090","1978","530000"
"3","1","1800","7200","1020","780","1964","500000"
"3","1.75","1510","8433","1220","290","1967","490000"
"3","2.25","1440","1362","1440","0","2014","469000"
"5","1.5","1830","9000","1030","800","1955","465000"
"3","2.25","1620","997","1540","80","2012","450000"
"4","2.5","2740","5700","2740","0","2006","438900"
"1","2","3000","204732","3000","0","1979","415000"
"5","2.25","1790","10300","1270","520","1961","409950"
"5","2.75","1690","4000","970","720","1943","399990"
"4","2.5","2030","11375","1330","700","1969","385000"
"3","2","1770","14400","1770","0","1959","381000"
"3","1.75","1680","7389","1150","530","1979","377000"
"3","2.75","2200","9600","1570","630","1977","375000"
"4","2.5","2420","8404","2420","0","2013","365000"
"4","2.5","2750","6259","2750","0","2002","360000"
"4","2.5","2000","5500","2000","0","2003","360000"
"5","2.5","2750","12350","2750","0","1987","357000"
"3","1","1240","5400","1060","180","1940","355000"
"3","2.25","1960","7000","1600","360","1980","355000"
"5","1","1340","11198","1340","0","1934","345950"
"4","1","1550","7620","1550","0","1957","345000"
"4","2.5","1820","7912","1820","0","1994","329500"
"6","3","2650","12870","2650","0","1977","325000"
"3","2.5","1920","5322","1920","0","1999","324000"
"3","1.75","1010","12000","1010","0","1977","315000"
"3","2.5","1020","1570","720","300","2004","300000"
"3","1","1040","9514","1040","0","1969","299000"
"4","3.25","2510","7686","2510","0","2003","290500"
"2","1","920","5000","490","430","1949","280300"
"4","2.5","1850","6037","1850","0","1991","278000"
"3","2.5","2495","4400","2495","0","2007","276000"
"2","2","1290","9041","950","340","1956","275000"
"4","2.25","1860","12693","1140","720","1978","266000"
"3","1.5","1400","10853","1400","0","1964","264950"
"4","1.5","1400","8500","1400","0","1975","257000"
"5","1.75","2140","12058","2140","0","1951","250750"
"3","1.75","1720","9342","1140","580","1981","245000"
"4","1.75","2020","8800","2020","0","1969","245000"
"3","2","1350","8587","1350","0","1998","244000"
"4","2","1610","6200","1610","0","1979","243500"
"3","1.5","1980","11214","1980","0","1959","235000"
"3","2","1690","6750","1210","480","1977","217000"
"3","2.5","1322","6006","1322","0","2009","215000"
"3","1","1010","9750","1010","0","1969","202000"
"3","2.25","1540","5449","1180","360","1989","176000"
"3","1","1060","8000","1060","0","1927","160000"
"3","1","1230","4800","1230","0","1916","125000"
"5","2.75","2880","20274","1660","1220","1959","1800000"
"5","3.75","3700","7920","2900","800","1983","1400000"
"4","2.5","2520","2600","1670","850","1925","1130000"
"4","3.25","3520","19354","2010","1510","1978","1110000"
"5","3.25","2680","3011","1870","810","1910","1030000"
"4","4","6050","84942","4150","1900","2009","930000"
"3","2.5","3090","5414","3090","0","1991","891500"
"3","1.5","1840","10125","1220","620","1959","830000"
"3","2.5","2000","1950","2000","0","2005","755000"
"4","1.5","1650","2970","1650","0","1903","752000"
"4","2.5","2030","4080","1730","300","1921","730000"
"3","2.5","2620","28703","2620","0","1985","725000"
"3","3.5","3030","11550","3030","0","1971","700000"
"4","1.75","1950","7139","1150","800","1957","700000"
"4","2.5","2770","10051","2770","0","1987","685000"
"3","2.25","2680","41804","2680","0","1989","676000"
"3","2.5","2240","3825","2240","0","1995","676000"
"3","1","1600","16868","990","610","1946","670000"
"3","1","1650","5102","1300","350","1953","665000"
"3","2","1770","2150","1770","0","1999","660000"
"3","2.5","2570","5500","1320","1250","1961","654000"
"4","2.5","3700","4500","3700","0","2007","650000"
"3","2","1470","4640","1470","0","1926","640000"
"3","2.25","1720","5234","1240","480","2011","608000"
"2","2","1340","5350","1340","0","1941","592500"
"4","2.75","3190","8737","3190","0","2006","587000"
"2","1.75","1830","7200","1070","760","1949","585000"
"3","2.5","2160","1250","1830","330","2010","585000"
"4","2.75","2730","6856","2730","0","2003","565000"
"3","2.25","2560","8040","1510","1050","1958","565000"
"4","3.5","3090","10510","2190","900","1991","549950"
"2","1.75","1660","5581","1660","0","2005","545000"
"2","1.5","1480","43645","1480","0","1974","525000"
"2","1","820","4206","820","0","1949","510000"
"3","2","2070","10023","1220","850","1981","490000"
"4","2.75","2560","8956","1500","1060","1968","485000"
"4","1.75","1670","10200","1390","280","1953","476500"
"3","1.75","1680","9460","1680","0","1959","466000"
"2","1.75","1390","4160","790","600","1916","460000"
"3","2.25","2520","78408","2520","0","1988","449888"
"4","2.25","2020","4840","1200","820","1925","430000"
"8","3.25","4300","10441","2800","1500","1979","430000"
"4","1","1350","3333","1350","0","1912","429000"
"3","1.5","1890","6183","1090","800","1967","400000"
"3","3","1860","2875","1710","150","2009","399950"
"2","1","870","3121","870","0","1923","395000"
"2","1.5","1000","1251","930","70","2006","377000"
"3","2.25","1330","8004","1330","0","1985","375000"
"4","2.5","2070","8658","2070","0","1999","372000"
"4","2.5","2531","6843","2531","0","2013","370000"
"5","2.75","2530","7601","1520","1010","1992","368500"
"3","1.5","1340","11744","1340","0","1950","357000"
"3","1","1130","11250","1130","0","1965","354000"
"3","2","1330","7419","1330","0","1985","344950"
"2","1","1070","6678","1070","0","1951","335000"
"4","2","1190","7877","1190","0","1946","329000"
"3","3.25","1480","1192","1180","300","2013","320000"
"3","1.75","1880","30346","1880","0","1988","310000"
"3","1","1150","9048","1150","0","1922","305000"
"4","2.5","2400","7215","2400","0","1992","300000"
"3","2.25","2000","7560","1400","600","1979","300000"
"3","1.75","1980","11274","1480","500","1968","299950"
"2","2.5","2410","7500","1550","860","1978","287000"
"3","1","1200","9322","1200","0","1954","280000"
"3","2.25","1260","1488","1260","0","2009","275000"
"3","2.25","1620","6415","1620","0","1989","275000"
"3","1.75","1460","7361","1460","0","1982","265800"
"4","1.75","1580","8856","1580","0","1979","259000"
"3","2","2070","9000","1450","620","1969","254000"
"4","1.5","2010","7561","1890","120","1921","245000"
"4","2","1750","7245","1050","700","1974","225000"
"3","1.5","1630","9282","1630","0","1963","224950"
"3","0.75","1080","5025","1080","0","1948","205000"
"3","1","1384","8960","1384","0","1965","180000"
"2","1","1200","9000","1200","0","1958","179950"
"3","1","1340","10260","1340","0","1968","172000"
"4","1.75","1700","6000","1700","0","1967","148900"
"5","5.5","7400","18898","6290","1110","2001","2980000"
"4","3.25","3860","7199","2870","990","2005","1500000"
"3","3.5","4240","21578","3500","740","1994","1390000"
"4","2.5","2960","20240","2960","0","1985","1250000"
"5","4.25","4420","13497","3510","910","2000","1210000"
"4","3.5","3640","6049","3640","0","2014","939000"
"4","2.5","3220","4400","2180","1040","1937","862500"
"4","2.5","2450","12987","2030","420","1980","836000"
"4","3.5","2760","4000","2000","760","1926","765000"
"4","2.5","2910","15016","2910","0","1990","765000"
"3","3.5","2350","10739","1340","1010","1940","760000"
"3","2.25","2190","107593","2190","0","1983","699950"
"4","3.5","4490","5805","3390","1100","2006","689000"
"5","3","3010","7357","3010","0","2008","659950"
"4","2.5","2340","8955","2340","0","1990","645000"
"4","1.75","1700","7800","1700","0","1975","600000"
"4","2.5","2430","6766","2430","0","1999","585000"
"2","1","940","3864","940","0","1918","543000"
"3","1.5","2400","10275","1540","860","1964","510000"
"4","2.75","3000","213008","3000","0","1975","500000"
"4","3.25","2820","6611","1410","1410","1958","485000"
"2","2.25","1360","1336","1360","0","2008","479950"
"3","1.75","2020","8970","1180","840","1981","475000"
"3","1","1600","7161","1600","0","1953","475000"
"4","2.5","4190","7504","4190","0","2004","460000"
"4","3","3280","62726","3280","0","1979","458000"
"4","1.75","1680","7800","1330","350","1966","451000"
"3","2.25","1830","13477","1170","660","1981","439000"
"4","2.75","2080","9600","1240","840","1979","436000"
"4","2.5","2650","9301","2650","0","2001","429000"
"3","1.75","2080","7700","1600","480","1968","426700"
"2","1","1040","4040","940","100","1928","425000"
"2","1","1280","4160","1020","260","1951","425000"
"3","1.5","1780","5000","1030","750","1958","420000"
"3","2.5","2390","3903","1970","420","2006","420000"
"3","1.5","1490","7275","1090","400","1974","415000"
"4","3","2430","7243","2430","0","2003","410000"
"5","2.75","2770","7620","1700","1070","1965","402000"
"3","1.75","1510","8385","1510","0","1968","400000"
"4","1","2370","30200","1570","800","1948","399888"
"4","3.25","1790","2460","1100","690","2000","385000"
"3","1.75","1560","14288","780","780","1944","385000"
"4","1.75","1610","11305","1610","0","1968","371000"
"4","2.5","2905","4874","2905","0","2003","365000"
"5","2.5","2880","6902","1680","1200","1976","360000"
"4","2.5","2570","11473","2570","0","2008","356500"
"3","1","1450","9586","1450","0","1950","340000"
"3","2.5","1676","18778","1676","0","1997","330000"
"3","1.5","1890","7650","1890","0","1966","325000"
"4","1","1750","68841","1750","0","1942","322000"
"2","1","860","8308","860","0","1948","315000"
"4","0.5","2300","5570","2300","0","1996","312500"
"4","2","1780","5043","870","910","1993","305000"
"3","2.5","2056","3564","2056","0","2014","303000"
"3","1.75","1840","7200","1220","620","1968","301000"
"4","1.75","2090","7416","1050","1040","1970","289950"
"2","1.5","720","4346","720","0","1942","287000"
"2","1","710","7120","710","0","1942","285950"
"4","2","1480","6324","1480","0","1943","278000"
"3","2.25","1630","10969","1630","0","1991","265000"
"3","1","1090","10296","1090","0","1950","249000"
"5","2.5","1760","10200","1760","0","1925","220000"
"3","1","1010","8863","1010","0","1990","180000"
"2","1","960","87991","960","0","1946","180000"
"2","1","1300","11400","1300","0","1961","170000"
"3","1","1220","6000","1220","0","1961","161500"
"3","1","1090","3315","1090","0","1969","143000"
"2","1","800","8550","800","0","1947","95000"
"4","3.5","5830","131116","5830","0","2005","1580000"
"4","3.25","4750","62365","4750","0","1988","1120000"
"3","1.75","1640","17583","1110","530","1969","410000"
"3","2.5","1610","1356","1240","370","2007","320000"
"4","1.5","1860","7808","1080","780","1953","450000"
"2","1","1140","8340","1140","0","1948","358000"
"3","1","1040","7490","1040","0","1969","339888"
"4","2.5","2060","7720","2060","0","1995","242550"
"4","3.5","4340","5500","2850","1490","2008","1280000"
"3","2.5","2070","4944","2070","0","1930","1250000"
"5","2.5","3370","8113","3370","0","2005","1250000"
"3","1","1880","5450","1880","0","1924","1000000"
"3","2","2160","15788","2160","0","1951","987000"
"3","3.5","2600","11920","2600","0","1969","985000"
"4","2.5","3020","4950","2020","1000","1921","975000"
"4","2.5","3570","6218","3570","0","2014","942990"
"5","4.5","4690","6705","3450","1240","1995","932808"
"4","3.5","3860","6543","3860","0","2014","900000"
"4","2.75","3140","7928","3140","0","2013","869950"
"5","3.75","3830","8131","3830","0","2005","852500"
"2","2.75","2700","9854","2700","0","2012","850000"
"4","2.5","3220","8379","3220","0","2004","748000"
"4","2.5","2300","9900","1600","700","1961","740000"
"4","2.25","2530","5000","1690","840","1925","734000"
"2","1","1860","3400","1010","850","1920","730000"
"5","2.75","2870","6593","2870","0","2006","730000"
"3","2.5","2410","46609","2410","0","1989","715000"
"4","2.5","3060","5000","3060","0","2006","710000"
"4","2.75","3000","6222","3000","0","2004","705000"
"6","3.25","2900","6400","2300","600","1977","696000"
"3","2.25","2120","13644","1420","700","1973","693000"
"4","2.75","2820","8009","2820","0","2001","682000"
"3","2.5","2060","2551","1900","160","2001","680000"
"3","2.5","1300","1590","1100","200","2014","675000"
"4","1.75","2410","6770","1220","1190","1924","625000"
"5","2.25","2460","8710","1330","1130","1976","599000"
"3","1.75","1520","5618","1170","350","1953","550000"
"2","1","1520","3360","830","690","1927","535000"
"3","1.75","1740","10000","1740","0","1976","517000"
"3","1.5","1680","17409","1680","0","1962","500000"
"3","2","1360","2500","730","630","1986","499950"
"2","1","1450","3090","1450","0","1919","499000"
"4","2.75","2720","6427","1650","1070","2008","469950"
"2","1.75","1170","4887","1020","150","1929","459000"
"4","2","2120","9442","1060","1060","1968","455000"
"3","1.75","2030","13700","1630","400","1976","435000"
"3","1","1740","4800","1740","0","1952","430000"
"4","2.25","1740","10875","1740","0","1967","429950"
"4","2.5","1950","5000","1950","0","2012","425000"
"4","1.5","1830","6985","1080","750","1967","424500"
"3","1.75","1590","11454","1590","0","1979","417000"
"4","2.5","1980","5020","1980","0","2007","405000"
"4","2.75","2400","3844","1200","1200","1974","403500"
"4","1.75","2520","15205","2040","480","1954","387846"
"2","2.5","1760","3710","1130","630","1988","385000"
"2","1","870","7500","870","0","1947","379950"
"3","2.25","3230","35306","3230","0","1987","370000"
"2","1.5","1200","6380","1200","0","1929","365000"
"3","2.25","2520","6170","1850","670","2003","364950"
"2","2.25","1230","989","1230","0","2007","356000"
"4","2.5","1830","5331","1830","0","2002","353000"
"2","2.25","1560","1705","1270","290","2006","347000"
"3","2.25","2730","9388","1390","1340","1975","345000"
"3","2.25","1440","5150","1440","0","1997","330000"
"3","2.5","2090","12027","2090","0","1991","327500"
"3","1","1600","7500","1600","0","1966","325000"
"3","2","2330","4950","1430","900","1900","325000"
"4","2.5","2120","5293","2120","0","2003","319990"
"3","1","970","6828","970","0","1928","315000"
"3","3.25","1480","983","1180","300","2013","312500"
"3","1.75","2270","7156","1370","900","1948","292000"
"2","1","1200","8750","1200","0","1948","290000"
"2","1","950","5650","950","0","1943","290000"
"3","1.75","1899","11325","1899","0","1943","289900"
"4","1.75","1660","10725","960","700","1956","282000"
"4","3","2390","7309","2390","0","1944","269950"
"2","2","1070","635","720","350","2008","256950"
"3","1.5","1320","7980","1320","0","1956","255000"
"3","2","1150","6000","1150","0","1956","252500"
"3","2.5","1700","6000","1700","0","1997","250000"
"3","1.5","2210","11111","2210","0","1934","250000"
"4","2.5","1750","11400","1750","0","1975","242000"
"4","1","1440","8250","1440","0","1959","220000"
"2","1.75","870","18537","870","0","1946","199950"
"3","1","1070","22489","1070","0","1967","195000"
"3","1","990","8255","990","0","1953","191000"
"3","1","1080","6250","1080","0","1950","124000"
"4","4.5","5270","12195","3400","1870","1979","2600000"
"4","3.25","5080","27755","5080","0","2001","1900000"
"4","2.75","2930","25697","2310","620","1964","1500000"
"5","3.5","2920","3000","2260","660","2014","1070000"
"4","3.25","4160","47480","4160","0","1995","1050000"
"5","3.25","4050","35600","4050","0","1990","1010000"
"4","2.25","2910","19168","2910","0","1988","998000"
"5","4","5610","22529","4090","1520","1996","995000"
"2","1.5","1800","4500","1000","800","1942","930000"
"3","1.75","3860","9000","1930","1930","1970","880000"
"6","3.5","2820","5400","1620","1200","1958","850000"
"4","2.5","3090","12511","3090","0","1998","780000"
"2","1.75","2210","9374","1560","650","1951","767500"
"5","4","4660","9900","2600","2060","1979","739000"
"2","1","2410","5930","1930","480","2007","725000"
"3","2.25","2680","10440","1540","1140","1963","721000"
"4","2.5","2510","5436","2510","0","2011","706000"
"4","2.75","2810","7302","2810","0","2002","699900"
"2","1.75","1180","900","780","400","2014","664950"
"4","1.5","1500","3075","1420","80","1929","651500"
"4","2.25","2070","8720","1360","710","1974","645000"
"3","1.75","2080","9162","1370","710","1960","638700"
"4","2.25","1920","8910","1200","720","1969","635000"
"4","2.5","2930","8679","2930","0","2014","635000"
"3","1.75","1940","167125","1480","460","1955","635000"
"3","2.5","2180","5000","1240","940","1977","625000"
"4","1","2210","4366","2210","0","1901","589000"
"1","1","1310","8667","1310","0","1918","575000"
"3","2","2290","9450","1670","620","1979","565000"
"4","2.5","1790","9787","1240","550","1983","560000"
"4","2.5","2390","38258","2390","0","2001","557500"
"3","2","2070","9195","1220","850","1982","539000"
"3","2.25","2100","40510","1320","780","1979","525000"
"3","2.5","1820","11012","1820","0","1988","505000"
"4","1.75","2040","6000","1020","1020","1943","500000"
"3","1.75","2430","8820","1630","800","1977","499900"
"4","2.5","2242","37451","2242","0","1995","490000"
"4","2.25","2680","4673","2680","0","1999","475000"
"3","2.5","2010","4059","2010","0","1998","471000"
"4","2.5","2820","39413","2820","0","1989","465000"
"4","2","1880","5100","1880","0","1952","453000"
"3","2.25","1750","9353","1210","540","1987","434000"
"3","2.5","2390","6435","1600","790","1978","432500"
"4","2.5","2010","16020","2010","0","1962","430000"
"3","2","1490","1286","1490","0","2014","429900"
"3","1.75","1680","14630","1680","0","1985","425000"
"2","1","910","4800","910","0","1923","422500"
"3","1.5","1370","7853","1370","0","1962","406000"
"3","2.5","2260","5500","1280","980","1910","405000"
"2","1","1020","4200","1020","0","1923","393000"
"2","1","700","4836","700","0","1926","380000"
"3","1.75","1380","5060","1380","0","1986","375000"
"3","2.5","1530","1131","1530","0","2009","375000"
"4","2.75","2200","5207","1120","1080","1951","370000"
"4","2","1710","7490","1320","390","1956","353750"
"3","2.25","1920","9672","1920","0","1984","345000"
"4","2.25","2010","7280","2010","0","1988","324900"
"3","2.25","1370","1533","1370","0","2009","315000"
"1","1","920","8282","920","0","1944","310000"
"2","2.25","1610","1968","1610","0","1979","305000"
"2","1.5","1400","1650","1400","0","1999","303000"
"3","1.75","1650","14633","1650","0","1958","292000"
"3","1.5","1590","8256","1090","500","1969","284850"
"3","1","960","9748","960","0","1922","265000"
"3","1.5","1500","10227","1000","500","1945","257100"
"3","1","1660","7650","1350","310","1910","250000"
"3","1.75","1370","14030","1370","0","1977","235000"
"3","1","1010","7920","1010","0","1925","216000"
"3","1","1070","14000","1070","0","1960","147000"
"3","1.75","2190","8500","2190","0","1957","1570000"
"4","3.5","5844","10766","5844","0","2007","1280000"
"4","2.75","4120","12500","2060","2060","1947","1250000"
"3","2.5","2870","5163","2870","0","2014","880000"
"6","3","2530","9000","2530","0","1978","830000"
"4","3.25","3200","4477","2390","810","2006","825000"
"4","2.5","3720","8633","3720","0","1999","820000"
"4","2.75","4600","322188","2400","2200","1989","800000"
"4","3.75","3370","6766","3370","0","2005","800000"
"4","3.5","3060","4777","3060","0","2007","740000"
"4","2.75","3440","8150","3440","0","2014","730000"
"3","2.5","2560","35265","2560","0","1981","700500"
"4","2.5","2510","3479","2510","0","2007","685000"
"4","2.25","2370","4950","1660","710","1976","670000"
"4","2.5","2730","4847","2730","0","2008","649000"
"4","2.75","2520","6398","2520","0","2014","642860"
"6","2.5","2560","8320","1370","1190","1961","632000"
"4","2.25","2900","9680","1990","910","1947","630000"
"1","1","1090","32010","1090","0","1958","598800"
"3","2.5","2400","99752","2400","0","1996","590000"
"3","1","1490","5700","1490","0","1916","578500"
"4","2.25","2380","36446","2380","0","1977","570000"
"2","1.75","1740","7290","1280","460","1950","550000"
"3","1.75","2300","11400","1520","780","1977","505000"
"3","2","1560","1156","1560","0","2014","500000"
"4","2.5","2230","54014","2230","0","2002","500000"
"4","1.75","1930","6720","1130","800","1959","495000"
"3","2.5","1890","10190","1890","0","1986","490000"
"3","1.75","1740","8528","1290","450","1939","480000"
"3","1.5","900","8690","900","0","1941","465000"
"4","2.75","2160","7200","1220","940","1976","445000"
"4","2.5","2798","5085","2798","0","2011","440000"
"4","2.75","2160","8148","1410","750","1978","435000"
"2","1.5","1320","1194","1320","0","2001","430000"
"2","1","830","6030","830","0","1925","425000"
"4","1.75","2230","9625","1180","1050","1955","415000"
"3","2.75","2390","7939","1610","780","1983","405300"
"4","2.5","1890","5395","1890","0","2006","388500"
"3","2.5","2470","7700","2470","0","1990","365000"
"4","2.5","1960","8540","1220","740","1955","355950"
"4","2.5","2100","10750","2100","0","1967","352500"
"3","2","1870","3378","1120","750","1913","340000"
"3","2","1830","12891","1830","0","1994","336500"
"3","1","910","10240","910","0","1969","330000"
"3","1","1160","12040","1160","0","1966","325000"
"3","1","1240","6090","1240","0","1950","305500"
"2","1","1290","3140","1290","0","2008","305000"
"2","1","1220","75794","1220","0","1963","300000"
"3","1","1190","9600","1190","0","1981","299500"
"4","1","1590","24330","1140","450","1942","291000"
"2","1.75","1700","18000","1700","0","1972","290000"
"3","2.25","2300","7200","1550","750","1978","287000"
"4","2","1980","10051","1980","0","1969","279000"
"2","1","900","57063","900","0","1938","275000"
"4","1.75","1710","7200","910","800","1975","271000"
"3","1","1010","14510","1010","0","1974","270000"
"3","1","1180","13650","1180","0","1967","255000"
"3","1.75","1500","7475","1500","0","1976","244000"
"3","1.75","1300","8976","1300","0","1967","236000"
"2","2.25","1660","2748","1660","0","1995","235000"
"4","1.5","1570","8775","1570","0","1943","228900"
"3","1.75","1900","7680","1260","640","1959","220000"
"5","1.5","1980","7958","1980","0","1962","215000"
"4","1.5","1360","8100","1360","0","1962","201000"
"3","3.5","3490","4000","2570","920","2009","1620000"
"4","1.75","2300","13342","2300","0","1934","1340000"
"4","2.5","2830","5932","2830","0","2014","1040000"
"3","3.5","2760","4500","2120","640","2004","952000"
"4","2.75","3800","12200","3800","0","1986","950000"
"4","2.5","3480","38985","3480","0","1989","895000"
"5","3","4080","7500","2720","1360","1961","825000"
"4","2.5","2180","9800","2180","0","1920","825000"
"3","3.5","2670","3000","1870","800","2014","825000"
"4","2.75","2840","4227","2840","0","2014","784950"
"4","2.5","3270","45537","3270","0","1993","735000"
"4","2.5","2820","4174","2820","0","2004","677000"
"3","1.75","1940","10245","1940","0","1957","650000"
"5","1","3020","4800","3020","0","1901","630000"
"4","3","1550","3350","860","690","1918","623500"
"4","2.5","2730","9260","2730","0","2008","620000"
"2","1.75","1990","6549","1170","820","1948","582500"
"2","1.75","1210","4141","910","300","1942","582000"
"3","2.5","1820","374616","1820","0","1999","580000"
"3","2","2290","11200","2290","0","1979","572500"
"2","1","1100","4000","1100","0","1906","570000"
"3","2.5","4040","8653","2900","1140","2006","565000"
"4","1.75","2660","11315","2660","0","1983","557000"
"3","1.75","2080","6609","1280","800","1950","520000"
"3","2.5","2490","21937","2490","0","1993","504750"
"3","2.5","2980","7338","2980","0","2006","480000"
"3","2.5","2670","4534","2670","0","2007","465750"
"3","2.5","1600","1311","1600","0","2005","465000"
"4","2.75","1900","6000","1300","600","1961","463000"
"3","2.25","1800","9800","1300","500","1959","420000"
"3","1","1790","7055","1520","270","1937","420000"
"2","0.75","1160","15029","870","290","1937","405000"
"3","2","1440","7425","1440","0","1965","405000"
"3","1.5","1600","10440","1600","0","1954","390000"
"2","1.5","1650","7311","860","790","1978","364000"
"3","1.25","2350","6200","1320","1030","1966","360000"
"3","1.75","1630","9403","1630","0","1983","357500"
"3","1.75","1480","9375","1480","0","1957","350000"
"5","2.5","2530","8583","2530","0","2004","349900"
"2","2.25","1550","1824","1550","0","2007","348500"
"3","2.5","2360","8093","2360","0","1995","339999"
"3","1.5","2400","8215","1200","1200","1961","338000"
"4","2.5","2650","5880","2650","0","2005","329000"
"3","2.5","1810","7350","1310","500","1984","327000"
"3","2.25","1570","43350","1570","0","1967","325000"
"2","1","750","1716","750","0","1949","319000"
"3","2.5","2240","6097","2240","0","2002","315000"
"3","2.5","1950","3000","1950","0","2001","315000"
"2","1.5","1000","1075","840","160","2007","303000"
"4","2.5","1580","3632","1580","0","2011","299900"
"3","1","1410","40500","1410","0","1961","288000"
"3","2.5","1660","7388","1660","0","2003","279000"
"3","1","870","8040","870","0","1953","276000"
"5","1.5","1950","9000","1130","820","1964","275000"
"1","1","520","4800","520","0","1930","275000"
"4","1.75","1360","7700","1360","0","1966","260000"
"3","2.5","1800","9000","1800","0","1983","258500"
"2","1","740","5000","740","0","1926","255000"
"3","2.5","1850","7200","1500","350","1979","249000"
"3","2.25","1422","3677","1422","0","2012","245000"
"2","1","1180","10200","1180","0","1955","244000"
"4","1.5","1570","6717","1570","0","1911","229950"
"3","1","1010","12705","1010","0","1959","229000"
"4","2.5","1680","6655","1680","0","2001","213400"
"3","2","1830","4992","1230","600","1953","210000"
"3","1.5","1090","10454","1090","0","1963","200000"
"2","1","800","7150","800","0","1933","175000"
"4","4","5780","7173","4130","1650","2008","2890000"
"4","3.5","3930","39098","3930","0","1999","1800000"
"3","1.75","2040","42693","2040","0","1980","1320000"
"3","2","2090","4077","1530","560","1931","1050000"
"8","3.75","3460","4600","2860","600","1987","808000"
"3","2.75","2070","54557","2070","0","1996","770000"
"4","2.5","3230","4290","3230","0","2004","765000"
"4","2.25","3140","12150","3140","0","1979","750000"
"4","2.5","2940","14071","2940","0","1986","675000"
"3","1.5","1890","4400","1890","0","1919","651000"
"5","2.75","3630","30570","3630","0","2000","633000"
"3","2.5","2070","10908","2070","0","1986","567000"
"3","2","2080","7020","1040","1040","1951","555000"
"3","2.25","1670","1596","1670","0","2014","539950"
"3","2.5","2250","11632","2250","0","1988","538000"
"2","2.25","1460","1623","1260","200","2005","495000"
"4","2","1400","3600","1100","300","1900","485000"
"3","1","1150","35415","1010","140","1950","450000"
"1","1","630","1362","630","0","1943","430000"
"3","2","1360","3120","1360","0","1989","396900"
"2","1","1200","6014","600","600","1949","395000"
"3","2","1270","6760","1270","0","1972","386100"
"3","2.5","1670","7740","1130","540","1974","375000"
"2","1","980","3915","980","0","1919","375000"
"3","1.5","1510","11200","1510","0","1960","340768"
"3","1","1770","12458","1770","0","1957","340500"
"2","1.75","1880","7208","940","940","1951","340000"
"3","2","1840","6755","1840","0","1989","329000"
"3","2","1640","9234","1060","580","1967","319000"
"3","2","1190","7840","1190","0","1918","311000"
"3","1","1820","8142","1040","780","1961","309000"
"4","2.5","2030","5202","2030","0","2001","304500"
"3","1.75","1820","8813","1820","0","1994","299500"
"3","1.5","1580","10100","1580","0","1961","296500"
"3","1","980","7480","830","150","1948","280000"
"3","1.75","1400","7735","1400","0","1989","269950"
"2","1.5","1290","1749","660","630","1969","268500"
"4","1.75","1930","7650","1280","650","1981","245000"
"3","1","1010","9611","1010","0","1973","241000"
"4","1.75","1480","9523","1120","360","1959","239900"
"3","1","1020","8100","1020","0","1954","229000"
"3","1","1180","32214","1180","0","1952","179500"
"4","3","2120","3600","1830","290","1908","1320000"
"3","2.5","2720","8622","2720","0","2002","420000"
"2","1","1210","4895","710","500","1951","285000"
"4","2.75","2240","7200","1140","1100","1967","260000"
"2","1","1360","9367","680","680","1924","255000"
"4","2.25","2320","8760","1160","1160","1966","248000"
"4","1.5","1820","22814","1820","0","1920","229000"
"5","2","1430","5600","1430","0","1947","133000"
"4","3","2790","3600","1880","910","1905","1050000"
"2","1","1140","3750","1140","0","1925","517000"
"5","3.25","4110","7920","3150","960","1921","1880000"
"3","2.5","1660","19168","1660","0","2008","975000"
"4","3.25","4140","46173","4140","0","2007","810000"
"3","1.5","2390","4452","1790","600","1929","790000"
"4","2.75","3430","13907","3430","0","1995","750000"
"3","2.5","2810","435600","2810","0","1995","745000"
"5","2.25","3700","7207","1850","1850","1970","722500"
"3","2","1460","6250","1460","0","1912","705000"
"3","1","1710","6195","1410","300","1946","670000"
"3","1.5","1380","4290","1080","300","1955","650000"
"5","2","2400","3500","1900","500","1911","650000"
"4","3","2320","4468","2160","160","1999","637500"
"4","3.5","4220","5817","2910","1310","2006","633000"
"4","2.5","2750","11830","2750","0","2014","627000"
"4","2.25","2660","22194","2180","480","1977","625000"
"6","2.5","3610","12033","3210","400","1970","610000"
"3","1.75","2300","12682","2300","0","1955","600000"
"5","3.5","3180","40946","1690","1490","1968","585000"
"3","2","2150","3880","1080","1070","1951","575000"
"3","1.75","1370","3300","1370","0","1927","570000"
"4","2.75","3250","5600","3250","0","2011","570000"
"4","2","1540","5000","1540","0","1913","550000"
"5","2.5","2780","9272","2780","0","2014","550000"
"3","2.25","2040","435600","2040","0","1983","525000"
"3","1.75","2310","36665","1580","730","1983","520000"
"3","1.5","1810","18483","1810","0","1954","520000"
"4","2","1680","3813","1680","0","1900","500000"
"3","2.5","1720","5940","1000","720","1977","499000"
"5","2.5","2550","6405","2550","0","2008","465000"
"2","2.25","1860","2670","1860","0","1986","462370"
"3","2.5","1150","1193","1020","130","2006","436000"
"4","2.25","2190","6800","1340","850","1969","411800"
"3","1","1300","14138","1300","0","1943","400000"
"4","2.75","2410","5225","2410","0","2001","379000"
"4","2.5","1900","5889","1900","0","1992","360000"
"3","1.75","1255","1113","1255","0","2010","360000"
"3","1.75","1010","8580","1010","0","1961","350000"
"3","2.25","1760","9621","1760","0","1995","350000"
"4","2.5","2400","4848","2400","0","2004","344000"
"4","2.25","2180","8000","1630","550","1975","340000"
"2","1","1300","6731","1300","0","1950","337500"
"3","2.75","1990","19991","1340","650","1977","335000"
"4","2","1440","4855","1440","0","1972","332500"
"5","1.5","2420","43560","1500","920","1962","332000"
"4","2.75","1930","3840","1170","760","1997","328000"
"2","2.25","1150","711","1150","0","2013","325000"
"3","2.25","1550","4411","1550","0","2001","324000"
"4","1.75","1440","8114","1440","0","1963","323000"
"2","1.5","1220","8409","1220","0","1948","317500"
"3","1.5","1150","3323","1150","0","1988","310000"
"3","2.5","1870","1436","1870","0","2004","289950"
"4","2.25","2150","8250","1240","910","1978","285000"
"3","2.25","1590","9425","1170","420","1985","278000"
"2","2","1700","7992","950","750","1980","274000"
"3","2.5","1830","2517","1830","0","2005","274000"
"3","1.75","1370","10866","1370","0","1945","270000"
"3","2.25","1550","6022","1550","0","1989","266000"
"4","2.5","2460","7800","1500","960","1977","261500"
"3","2.25","1950","9600","1200","750","1987","260000"
"4","1.75","1710","7140","1010","700","1968","250000"
"3","2","1360","9688","1360","0","1983","244000"
"4","1.75","1500","12560","1000","500","1977","239000"
"3","1.5","1390","11340","1390","0","1963","232000"
"3","1","980","5000","980","0","1954","221000"
"1","1","1050","7583","1050","0","1947","210000"
"3","2","1540","8316","1540","0","1954","202500"
"2","1","920","5250","920","0","1906","200000"
"4","3.75","3790","7200","2530","1260","1931","2200000"
"4","2.5","3070","7207","2670","400","1927","1720000"
"4","3.25","3020","4000","1920","1100","1927","1270000"
"4","3","3180","4649","2070","1110","1925","1130000"
"4","4.5","4920","270236","3820","1100","2006","1040000"
"3","3","4230","54977","3780","450","1951","887500"
"4","2.5","3580","97574","3580","0","2004","760000"
"4","2","3210","8400","2040","1170","1914","756450"
"4","2.5","2910","20946","2350","560","1976","705000"
"3","1.5","1580","5000","1290","290","1939","700000"
"4","3.25","2600","2074","2150","450","2011","661000"
"4","2.75","3010","6854","2570","440","2012","625000"
"3","2.75","1840","2060","1700","140","2013","599000"
"3","1.75","2010","3800","2010","0","1922","575000"
"1","1","1370","6250","1370","0","1921","565000"
"6","3","2870","206474","2330","540","1960","540000"
"4","3.5","2710","1569","2040","670","1997","539500"
"4","2.5","2660","65340","2660","0","1988","523000"
"4","0.75","1960","8277","1320","640","1923","520000"
"3","1.75","1490","12000","1490","0","1956","515000"
"5","1.75","1880","48787","1880","0","1922","515000"
"2","1","1310","4000","1310","0","1913","510000"
"4","2.5","3630","8387","3630","0","1997","490000"
"3","2","2200","21890","1200","1000","1961","472000"
"4","2.5","2820","15233","1820","1000","1972","450000"
"3","2.5","2790","16173","2790","0","1988","445000"
"3","1.75","1640","8529","1640","0","1951","440000"
"4","2.5","2940","7590","2940","0","1991","435000"
"3","1.75","2410","51763","1410","1000","1981","432000"
"2","1","760","4000","760","0","1944","415000"
"3","2","1660","8174","830","830","1981","405000"
"3","1.5","1280","9600","1280","0","1960","405000"
"4","2","1980","15354","1980","0","1977","395000"
"4","2.75","2280","5013","2280","0","2009","395000"
"3","1.75","2092","250905","2092","0","1981","390000"
"3","2.5","1720","10031","1720","0","1993","383000"
"3","1.5","1400","14850","1400","0","1910","383000"
"5","3","3450","9914","3450","0","2004","380000"
"3","3.25","2660","17852","2660","0","2014","379000"
"3","2.25","1860","5028","1860","0","2012","355000"
"4","2.5","2160","9682","2160","0","1999","345500"
"4","2.5","2190","7000","2190","0","1997","334950"
"4","2.25","2380","122038","2380","0","1984","330000"
"4","2.25","1920","11603","1920","0","1967","325000"
"3","2.25","1440","6443","1440","0","1995","325000"
"2","1","1160","7500","1160","0","1916","312000"
"3","2.5","2200","7201","2200","0","1994","302495"
"4","2.5","1860","8709","1860","0","1994","292500"
"4","2.25","1960","10400","1220","740","1985","285000"
"3","1.5","1820","8750","1200","620","1958","276000"
"3","1","1290","11250","1290","0","1956","275000"
"5","2.5","2406","7093","2406","0","2006","270500"
"3","2.25","1950","8661","1950","0","1966","269000"
"3","2.5","1584","3200","1584","0","2011","263000"
"3","1.75","2050","11313","1520","530","1987","252000"
"3","1.5","1072","4339","1072","0","2009","250000"
"3","1","1240","18000","1240","0","1943","235000"
"3","1","1010","7633","1010","0","1961","225000"
"3","1.5","1200","8404","1200","0","1964","219950"
"3","1","1060","9954","1060","0","1960","215000"
"3","1","920","8400","920","0","1963","206000"
"3","1","960","10815","960","0","1900","199999"
"5","4.5","4350","13405","4350","0","2014","1380000"
"4","2","3100","8000","2040","1060","1939","1000000"
"4","2.5","2970","5722","2970","0","2005","715000"
"3","3","2090","7440","1290","800","1922","700000"
"5","3.5","3990","10120","2820","1170","1990","650000"
"4","2.25","2280","8550","1660","620","1977","539500"
"2","2.5","2730","7246","2730","0","1998","535000"
"2","1","1440","7130","1210","230","1948","500000"
"3","1.5","1540","20281","1540","0","1977","480000"
"2","2","1140","12000","1140","0","1943","480000"
"4","2.5","2690","9551","2690","0","1992","439000"
"5","1.75","1960","7875","1960","0","1968","434400"
"3","1.75","1820","4160","1340","480","1976","422800"
"2","1","1510","6807","1090","420","1939","415000"
"3","1.75","1340","9975","1340","0","1961","410000"
"3","1","940","7910","940","0","1959","370000"
"3","2","1750","7000","1750","0","1993","363000"
"4","2.5","2390","7056","2390","0","1990","360000"
"3","2.25","2020","9000","2020","0","1979","345000"
"4","1","1120","3844","1120","0","1972","329000"
"2","1","960","4800","960","0","1912","325000"
"3","1","1270","7400","1270","0","1956","320000"
"3","2.5","1610","8544","1610","0","1994","319000"
"2","1","1400","4500","900","500","1922","310000"
"2","1.75","1960","30144","980","980","1957","280000"
"3","2.25","1510","6071","1150","360","1985","265000"
"3","1.5","1110","10296","1110","0","1964","255000"
"3","1","1580","8206","1100","480","1962","255000"
"3","2","1610","13309","1610","0","1967","246700"
"2","2","1040","4750","850","190","1950","160000"
"3","1.5","1170","11530","1170","0","1960","157000"
"4","4.25","4590","17621","3160","1430","2003","1140000"
"6","3","3300","4218","2200","1100","1970","920000"
"4","2.75","2860","6867","1560","1300","1946","874000"
"5","3.5","4890","12039","3590","1300","2014","865950"
"4","3.25","3830","10005","3830","0","2001","860000"
"4","2.5","2920","14210","2920","0","1978","795000"
"4","2.25","2260","11900","2260","0","1976","605000"
"4","1.5","1430","5500","1430","0","1910","575000"
"3","2.5","2110","8164","2110","0","1990","535000"
"3","2","1620","7800","1200","420","1969","525000"
"4","1","1980","7015","1260","720","1973","524000"
"4","2","2330","7778","1230","1100","1961","500000"
"3","2.75","1670","3330","1670","0","1925","485000"
"3","1.75","1330","14560","1330","0","1983","475000"
"3","2.75","1050","7200","1050","0","1985","473000"
"3","2.5","1980","7309","1980","0","1993","455000"
"4","3","2490","5064","2490","0","2007","449400"
"5","1.75","3700","9140","1850","1850","1957","415000"
"3","1.75","1620","10000","1620","0","1918","399000"
"2","1","1320","3090","1320","0","1908","381156"
"4","2.5","2301","6452","2301","0","2010","375500"
"3","2.5","2750","37096","2750","0","1989","375000"
"4","2.5","2650","5706","2650","0","2005","370000"
"3","2.5","1260","972","840","420","2008","353500"
"3","1.75","1470","8645","1470","0","1949","350000"
"2","2","1420","5185","1420","0","2004","335000"
"3","2","1340","9764","1340","0","1944","275000"
"2","2","1360","5433","1360","0","1974","255000"
"4","2.5","1987","6000","1987","0","2011","255000"
"6","2.5","2590","10890","1340","1250","1970","250000"
"3","1.75","1780","35233","1420","360","1979","250000"
"4","2","2460","5921","1230","1230","1948","247500"
"3","1.75","1350","7588","1350","0","1993","241250"
"4","2.25","1900","9600","1900","0","1967","215000"
"2","1","1010","10057","1010","0","1961","199950"
"3","1.5","1190","10116","1190","0","1968","160134"
"4","1","1730","7350","1730","0","1970","152500"
"3","1","1150","8050","1150","0","1956","123300"
"4","3","2400","5400","1600","800","1965","475000"
"3","2.5","1860","21876","1860","0","1992","350000"
"5","3.25","5620","12672","4140","1480","1916","2500000"
"5","3","2840","6240","2440","400","1905","1430000"
"4","2.5","1940","4875","1940","0","1925","1150000"
"5","2.75","3300","7560","3300","0","2007","1110000"
"4","2.5","3170","47502","3170","0","1988","1040000"
"4","2.5","3550","10233","3550","0","1996","920000"
"4","2.75","3120","5000","3120","0","2010","800000"
"4","1.75","2460","10061","1410","1050","1961","790000"
"3","3","1950","1983","1610","340","2009","785000"
"3","2.5","2620","9112","2620","0","1995","738000"
"4","2.5","3230","7766","3230","0","2005","714000"
"5","2.5","2830","25958","1610","1220","1979","700000"
"6","2.5","3180","9375","1590","1590","1967","680000"
"10","3","2920","3745","1860","1060","1913","660000"
"2","1.75","1180","904","780","400","2014","659000"
"4","3.5","3880","8244","3060","820","2007","620000"
"5","2.5","3150","5150","1870","1280","1907","614000"
"3","2.5","2560","5238","2560","0","2001","577000"
"3","2.5","1590","2910","1110","480","1984","575000"
"4","2.75","2560","83200","1860","700","1980","562000"
"4","1.75","2250","8458","1450","800","1954","559000"
"5","2.75","2810","13144","1440","1370","1964","555000"
"2","1","950","4080","950","0","1924","550000"
"3","2.5","3100","100188","1820","1280","1981","540000"
"5","2","3020","6000","1860","1160","1925","530000"
"3","2","1690","5100","1690","0","1907","515000"
"5","2","2220","6000","1390","830","1925","515000"
"3","2.25","2210","7916","2210","0","1978","500000"
"3","2.75","2430","14861","1530","900","1988","495000"
"3","1.5","1580","1228","1580","0","2014","495000"
"5","2.5","3270","6129","3270","0","2004","485000"
"3","2","2770","89298","2770","0","2004","472000"
"4","2.5","2060","8968","1190","870","1975","459500"
"3","1","1260","8910","1260","0","1949","445000"
"3","2.25","3050","10689","3050","0","1988","438500"
"5","1.5","1890","10880","1890","0","1962","420000"
"2","2.25","1130","2191","1130","0","2010","415000"
"3","1","1040","9600","1040","0","1978","399950"
"4","2.5","2640","10720","2640","0","1999","377500"
"3","2","1540","1827","1540","0","2005","376000"
"4","1.75","2140","159865","1140","1000","1960","362950"
"4","2.5","2490","4751","2490","0","2001","360000"
"3","3.5","1320","1161","1320","0","2010","345000"
"2","1","920","8612","920","0","1947","340895"
"3","2.5","1690","1200","1410","280","2014","336900"
"3","2","2320","7800","1160","1160","1960","320000"
"3","2","1900","9513","1900","0","1995","315000"
"4","2.75","2520","6964","1260","1260","1987","307000"
"3","2.25","1646","12414","1646","0","1996","305000"
"5","2.75","3130","169448","1580","1550","1973","302300"
"3","2","1540","10410","1540","0","1967","275000"
"2","1","710","4240","710","0","1942","271000"
"3","1.75","1320","6530","1320","0","1989","262000"
"3","2.25","1320","963","1040","280","2007","255000"
"3","1","1520","7800","1120","400","1967","250000"
"4","1","1000","7134","1000","0","1943","239900"
"3","1.5","1360","7488","1050","310","1975","238000"
"2","1","720","5913","720","0","1920","230000"
"3","1","1230","9720","1230","0","1969","220000"
"2","1.5","1068","1158","1068","0","1990","207000"
"2","1","840","7200","840","0","1907","202000"
"3","1","2120","31564","1220","900","1942","200000"
"3","1.5","1430","5200","1030","400","1977","195000"
"3","1.75","1130","7000","1130","0","1978","185000"
"3","3.25","4220","41300","2460","1760","1958","3300000"
"4","4","4690","6900","3480","1210","2001","1950000"
"5","5","4930","14649","4160","770","2000","1700000"
"4","3.25","2850","4100","1820","1030","1908","1540000"
"5","4","4180","5432","4180","0","2014","1260000"
"3","2","2480","13310","2480","0","1955","1200000"
"3","2.75","2700","22343","2700","0","1977","1060000"
"4","2.5","3220","5262","3220","0","2003","825000"
"4","2.5","2420","7200","2420","0","1991","771000"
"3","2.5","2750","16000","2560","190","1981","739000"
"3","2.5","1460","8800","1460","0","1956","685000"
"4","2","2360","6000","2360","0","1904","640000"
"6","3","2470","9328","2470","0","1982","630000"
"4","2.75","1950","6930","1250","700","1960","621000"
"4","2.5","3040","9606","3040","0","2003","620000"
"2","2.75","1910","1369","1910","0","2002","609850"
"3","2.5","2430","5400","2430","0","2007","550000"
"4","3","1780","7260","1780","0","1964","538200"
"3","0.75","920","20412","920","0","1950","530000"
"4","2.25","1910","8005","1280","630","1960","528000"
"3","2.25","2100","3000","2100","0","1996","495000"
"3","1.75","1480","800","1000","480","2014","469000"
"3","1.75","1290","8580","1290","0","1962","460000"
"4","2","2380","4500","1470","910","1926","455000"
"3","1.75","2090","7505","2090","0","1967","424950"
"4","2.5","2110","9825","2110","0","2000","420000"
"3","2.5","1980","4274","1980","0","2003","415000"
"4","1.5","2230","11536","1220","1010","1954","355000"
"3","1.75","1490","10344","1490","0","1985","350000"
"3","1","1920","6710","1320","600","1959","350000"
"3","2","1570","14992","1570","0","2001","340000"
"4","2","1800","13551","1800","0","1974","305000"
"5","2.5","2580","11250","1410","1170","1964","260000"
"1","1","720","123710","720","0","1935","250000"
"2","1","830","9000","830","0","1939","235000"
"6","1.5","1810","4838","1050","760","1905","230000"
"3","2","1560","7000","1560","0","1968","226500"
"2","2.5","1570","1268","1570","0","2007","208400"
"3","1","1640","8100","1040","600","1939","190000"
"3","1.5","760","40039","760","0","1906","190000"
"3","2","1460","11481","1170","290","1995","189000"
"4","1","1540","7350","770","770","1969","160000"
"2","1","870","5700","870","0","1957","150000"
"4","2.5","2600","11542","2200","400","1939","1230000"
"3","2.5","2460","6600","1560","900","1929","931000"
"3","2.5","3520","237402","3520","0","2004","905000"
"3","1","1160","10732","1160","0","1953","875000"
"3","1.5","1890","5000","1890","0","1929","826000"
"4","2.5","3210","18901","3210","0","1993","825000"
"3","3.25","2260","3727","1880","380","2003","795000"
"3","3.25","3450","15586","2690","760","1989","755000"
"3","2","1890","6620","1890","0","1954","690000"
"4","2.75","3250","10000","3250","0","2014","689000"
"4","2.5","2510","5936","2510","0","1998","665000"
"5","2.75","2730","6401","2730","0","2015","614285"
"6","3","2470","9267","2470","0","1982","609000"
"3","2.5","2570","9487","2570","0","1989","605000"
"3","1.75","1410","4080","1000","410","1950","600000"
"3","1.75","1820","3140","1820","0","1949","582000"
"3","2.5","2300","18540","1800","500","1961","579000"
"4","2.5","2280","27441","2280","0","1996","575000"
"5","2.25","2130","4360","1240","890","1959","565000"
"4","1.75","1780","8768","1050","730","1951","518000"
"4","2","1630","1724","1030","600","1915","509000"
"4","2.5","2100","8886","2100","0","1964","485000"
"3","2.5","2720","40813","2720","0","2001","460000"
"3","1.75","1660","9697","1660","0","1952","449000"
"3","2.5","1780","2778","1530","250","2007","443000"
"4","1.5","1100","3300","1100","0","1919","441000"
"3","2.25","1400","6970","1400","0","1984","425000"
"3","2.75","1840","68479","1340","500","1989","406500"
"3","2","1100","9165","1100","0","1969","397000"
"3","1.5","1520","8519","1520","0","1954","365000"
"3","1.75","1220","9732","1220","0","1965","333500"
"3","2.5","1990","9995","1990","0","1996","330000"
"3","2.5","1820","1866","1570","250","2008","327500"
"4","2.75","1580","3770","1080","500","2002","315000"
"3","2","1310","1361","1310","0","2003","310000"
"4","2.75","1810","7350","1200","610","1980","272000"
"3","1.75","1350","7686","1350","0","1987","261000"
"3","1","1180","5350","1180","0","1959","260000"
"3","1","1400","10425","1400","0","1968","241500"
"3","1.75","1590","7931","1190","400","1979","240000"
"2","1.5","1556","20000","1556","0","1957","221700"
"3","2","1680","7000","1680","0","1968","219200"
"2","1","1070","6120","1070","0","1962","209000"
"4","1","1030","6621","1030","0","1955","205000"
"3","1","900","4770","900","0","1969","146000"
